PokerStars Hand #189310862526: Tournament #2369778109, $0.23+$0.02 USD Hold'em No Limit - Level I (10/20) - 2018/07/29 20:11:28 ET
Table '2369778109 1' 9-max Seat #1 is the button
Seat 1: intelllect (1500 in chips) 
Seat 2: chaq*n voy (1500 in chips) 
Seat 3: flagao (1500 in chips) 
Seat 4: casttilho21 (1500 in chips) 
Seat 5: biroxadrez (1500 in chips) 
Seat 6: thiagoflauzi (1500 in chips) 
Seat 7: Paco Mechou (1500 in chips) 
Seat 8: rtrombin22 (1500 in chips) 
Seat 9: berilo.rama (1500 in chips) 
intelllect: posts the ante 3
chaq*n voy: posts the ante 3
flagao: posts the ante 3
casttilho21: posts the ante 3
biroxadrez: posts the ante 3
thiagoflauzi: posts the ante 3
Paco Mechou: posts the ante 3
rtrombin22: posts the ante 3
berilo.rama: posts the ante 3
chaq*n voy: posts small blind 10
flagao: posts big blind 20
*** HOLE CARDS ***
Dealt to flagao [Td 7h]
casttilho21: folds 
biroxadrez: folds 
thiagoflauzi: folds 
Paco Mechou: calls 20
rtrombin22: folds 
berilo.rama: calls 20
intelllect: calls 20
chaq*n voy: calls 10
flagao: checks 
*** FLOP *** [4d Qh 4h]
chaq*n voy: checks 
flagao: checks 
Paco Mechou: checks 
berilo.rama: checks 
intelllect: checks 
*** TURN *** [4d Qh 4h] [Kd]
chaq*n voy: checks 
flagao: checks 
Paco Mechou: bets 40
berilo.rama: folds 
intelllect: folds 
chaq*n voy: folds 
flagao: folds 
Uncalled bet (40) returned to Paco Mechou
Paco Mechou collected 127 from pot
Paco Mechou: doesn't show hand 
*** SUMMARY ***
Total pot 127 | Rake 0 
Board [4d Qh 4h Kd]
Seat 1: intelllect (button) folded on the Turn
Seat 2: chaq*n voy (small blind) folded on the Turn
Seat 3: flagao (big blind) folded on the Turn
Seat 4: casttilho21 folded before Flop (didn't bet)
Seat 5: biroxadrez folded before Flop (didn't bet)
Seat 6: thiagoflauzi folded before Flop (didn't bet)
Seat 7: Paco Mechou collected (127)
Seat 8: rtrombin22 folded before Flop (didn't bet)
Seat 9: berilo.rama folded on the Turn



PokerStars Hand #189310907970: Tournament #2369778109, $0.23+$0.02 USD Hold'em No Limit - Level I (10/20) - 2018/07/29 20:13:05 ET
Table '2369778109 1' 9-max Seat #2 is the button
Seat 1: intelllect (1477 in chips) 
Seat 2: chaq*n voy (1477 in chips) 
Seat 3: flagao (1477 in chips) 
Seat 4: casttilho21 (1497 in chips) 
Seat 5: biroxadrez (1497 in chips) 
Seat 6: thiagoflauzi (1497 in chips) 
Seat 7: Paco Mechou (1604 in chips) 
Seat 8: rtrombin22 (1497 in chips) 
Seat 9: berilo.rama (1477 in chips) 
intelllect: posts the ante 3
chaq*n voy: posts the ante 3
flagao: posts the ante 3
casttilho21: posts the ante 3
biroxadrez: posts the ante 3
thiagoflauzi: posts the ante 3
Paco Mechou: posts the ante 3
rtrombin22: posts the ante 3
berilo.rama: posts the ante 3
flagao: posts small blind 10
casttilho21: posts big blind 20
*** HOLE CARDS ***
Dealt to flagao [8d 4s]
biroxadrez: folds 
thiagoflauzi: folds 
Paco Mechou: calls 20
rtrombin22: folds 
berilo.rama: folds 
intelllect: folds 
chaq*n voy: folds 
flagao: folds 
casttilho21: checks 
*** FLOP *** [7c 7d Ks]
casttilho21: bets 40
Paco Mechou: folds 
Uncalled bet (40) returned to casttilho21
casttilho21 collected 77 from pot
casttilho21: doesn't show hand 
*** SUMMARY ***
Total pot 77 | Rake 0 
Board [7c 7d Ks]
Seat 1: intelllect folded before Flop (didn't bet)
Seat 2: chaq*n voy (button) folded before Flop (didn't bet)
Seat 3: flagao (small blind) folded before Flop
Seat 4: casttilho21 (big blind) collected (77)
Seat 5: biroxadrez folded before Flop (didn't bet)
Seat 6: thiagoflauzi folded before Flop (didn't bet)
Seat 7: Paco Mechou folded on the Flop
Seat 8: rtrombin22 folded before Flop (didn't bet)
Seat 9: berilo.rama folded before Flop (didn't bet)



PokerStars Hand #189310926804: Tournament #2369778109, $0.23+$0.02 USD Hold'em No Limit - Level I (10/20) - 2018/07/29 20:13:47 ET
Table '2369778109 1' 9-max Seat #3 is the button
Seat 1: intelllect (1474 in chips) 
Seat 2: chaq*n voy (1474 in chips) 
Seat 3: flagao (1464 in chips) 
Seat 4: casttilho21 (1551 in chips) 
Seat 5: biroxadrez (1494 in chips) 
Seat 6: thiagoflauzi (1494 in chips) 
Seat 7: Paco Mechou (1581 in chips) 
Seat 8: rtrombin22 (1494 in chips) 
Seat 9: berilo.rama (1474 in chips) 
intelllect: posts the ante 3
chaq*n voy: posts the ante 3
flagao: posts the ante 3
casttilho21: posts the ante 3
biroxadrez: posts the ante 3
thiagoflauzi: posts the ante 3
Paco Mechou: posts the ante 3
rtrombin22: posts the ante 3
berilo.rama: posts the ante 3
casttilho21: posts small blind 10
biroxadrez: posts big blind 20
*** HOLE CARDS ***
Dealt to flagao [5s Th]
thiagoflauzi: folds 
Paco Mechou: calls 20
rtrombin22: calls 20
berilo.rama: folds 
intelllect: folds 
chaq*n voy: calls 20
flagao: folds 
casttilho21: folds 
casttilho21 is sitting out
biroxadrez: checks 
*** FLOP *** [As 8c Ac]
biroxadrez: checks 
Paco Mechou: checks 
rtrombin22: checks 
chaq*n voy: bets 59
biroxadrez: folds 
Paco Mechou: folds 
rtrombin22: folds 
Uncalled bet (59) returned to chaq*n voy
chaq*n voy collected 117 from pot
*** SUMMARY ***
Total pot 117 | Rake 0 
Board [As 8c Ac]
Seat 1: intelllect folded before Flop (didn't bet)
Seat 2: chaq*n voy collected (117)
Seat 3: flagao (button) folded before Flop (didn't bet)
Seat 4: casttilho21 (small blind) folded before Flop
Seat 5: biroxadrez (big blind) folded on the Flop
Seat 6: thiagoflauzi folded before Flop (didn't bet)
Seat 7: Paco Mechou folded on the Flop
Seat 8: rtrombin22 folded on the Flop
Seat 9: berilo.rama folded before Flop (didn't bet)



PokerStars Hand #189310957526: Tournament #2369778109, $0.23+$0.02 USD Hold'em No Limit - Level I (10/20) - 2018/07/29 20:14:53 ET
Table '2369778109 1' 9-max Seat #4 is the button
Seat 1: intelllect (1471 in chips) 
Seat 2: chaq*n voy (1568 in chips) 
Seat 3: flagao (1461 in chips) 
Seat 4: casttilho21 (1538 in chips) is sitting out
Seat 5: biroxadrez (1471 in chips) 
Seat 6: thiagoflauzi (1491 in chips) 
Seat 7: Paco Mechou (1558 in chips) 
Seat 8: rtrombin22 (1471 in chips) 
Seat 9: berilo.rama (1471 in chips) 
intelllect: posts the ante 3
chaq*n voy: posts the ante 3
flagao: posts the ante 3
casttilho21: posts the ante 3
biroxadrez: posts the ante 3
thiagoflauzi: posts the ante 3
Paco Mechou: posts the ante 3
rtrombin22: posts the ante 3
berilo.rama: posts the ante 3
biroxadrez: posts small blind 10
thiagoflauzi: posts big blind 20
*** HOLE CARDS ***
Dealt to flagao [Ac 7c]
Paco Mechou: calls 20
rtrombin22: folds 
casttilho21 has returned
berilo.rama: folds 
intelllect: folds 
chaq*n voy: calls 20
flagao: raises 40 to 60
casttilho21: folds 
biroxadrez: folds 
thiagoflauzi: calls 40
Paco Mechou: calls 40
chaq*n voy: calls 40
*** FLOP *** [6s 7d 9h]
thiagoflauzi: checks 
Paco Mechou: bets 60
chaq*n voy: folds 
flagao: raises 200 to 260
thiagoflauzi: folds 
Paco Mechou: folds 
Uncalled bet (200) returned to flagao
flagao collected 397 from pot
flagao: doesn't show hand 
*** SUMMARY ***
Total pot 397 | Rake 0 
Board [6s 7d 9h]
Seat 1: intelllect folded before Flop (didn't bet)
Seat 2: chaq*n voy folded on the Flop
Seat 3: flagao collected (397)
Seat 4: casttilho21 (button) folded before Flop (didn't bet)
Seat 5: biroxadrez (small blind) folded before Flop
Seat 6: thiagoflauzi (big blind) folded on the Flop
Seat 7: Paco Mechou folded on the Flop
Seat 8: rtrombin22 folded before Flop (didn't bet)
Seat 9: berilo.rama folded before Flop (didn't bet)



PokerStars Hand #189310996498: Tournament #2369778109, $0.23+$0.02 USD Hold'em No Limit - Level I (10/20) - 2018/07/29 20:16:19 ET
Table '2369778109 1' 9-max Seat #5 is the button
Seat 1: intelllect (1468 in chips) 
Seat 2: chaq*n voy (1505 in chips) 
Seat 3: flagao (1735 in chips) 
Seat 4: casttilho21 (1535 in chips) 
Seat 5: biroxadrez (1458 in chips) 
Seat 6: thiagoflauzi (1428 in chips) 
Seat 7: Paco Mechou (1435 in chips) 
Seat 8: rtrombin22 (1468 in chips) 
Seat 9: berilo.rama (1468 in chips) 
intelllect: posts the ante 3
chaq*n voy: posts the ante 3
flagao: posts the ante 3
casttilho21: posts the ante 3
biroxadrez: posts the ante 3
thiagoflauzi: posts the ante 3
Paco Mechou: posts the ante 3
rtrombin22: posts the ante 3
berilo.rama: posts the ante 3
thiagoflauzi: posts small blind 10
Paco Mechou: posts big blind 20
*** HOLE CARDS ***
Dealt to flagao [8s 5c]
rtrombin22: folds 
berilo.rama: folds 
intelllect: folds 
chaq*n voy: folds 
flagao: folds 
casttilho21: calls 20
biroxadrez: folds 
thiagoflauzi: calls 10
Paco Mechou: checks 
*** FLOP *** [Kc 6d Qd]
thiagoflauzi: checks 
Paco Mechou: bets 20
casttilho21: calls 20
thiagoflauzi: folds 
*** TURN *** [Kc 6d Qd] [9d]
Paco Mechou: bets 60
casttilho21: raises 124 to 184
Paco Mechou: folds 
Uncalled bet (124) returned to casttilho21
casttilho21 collected 247 from pot
casttilho21: doesn't show hand 
*** SUMMARY ***
Total pot 247 | Rake 0 
Board [Kc 6d Qd 9d]
Seat 1: intelllect folded before Flop (didn't bet)
Seat 2: chaq*n voy folded before Flop (didn't bet)
Seat 3: flagao folded before Flop (didn't bet)
Seat 4: casttilho21 collected (247)
Seat 5: biroxadrez (button) folded before Flop (didn't bet)
Seat 6: thiagoflauzi (small blind) folded on the Flop
Seat 7: Paco Mechou (big blind) folded on the Turn
Seat 8: rtrombin22 folded before Flop (didn't bet)
Seat 9: berilo.rama folded before Flop (didn't bet)



PokerStars Hand #189311037680: Tournament #2369778109, $0.23+$0.02 USD Hold'em No Limit - Level I (10/20) - 2018/07/29 20:17:49 ET
Table '2369778109 1' 9-max Seat #6 is the button
Seat 1: intelllect (1465 in chips) 
Seat 2: chaq*n voy (1502 in chips) 
Seat 3: flagao (1732 in chips) 
Seat 4: casttilho21 (1679 in chips) 
Seat 5: biroxadrez (1455 in chips) 
Seat 6: thiagoflauzi (1405 in chips) 
Seat 7: Paco Mechou (1332 in chips) 
Seat 8: rtrombin22 (1465 in chips) 
Seat 9: berilo.rama (1465 in chips) 
intelllect: posts the ante 3
chaq*n voy: posts the ante 3
flagao: posts the ante 3
casttilho21: posts the ante 3
biroxadrez: posts the ante 3
thiagoflauzi: posts the ante 3
Paco Mechou: posts the ante 3
rtrombin22: posts the ante 3
berilo.rama: posts the ante 3
Paco Mechou: posts small blind 10
rtrombin22: posts big blind 20
*** HOLE CARDS ***
Dealt to flagao [Ad 6h]
berilo.rama: folds 
intelllect: folds 
chaq*n voy: folds 
flagao: raises 40 to 60
casttilho21: raises 1616 to 1676 and is all-in
biroxadrez: folds 
thiagoflauzi: folds 
Paco Mechou: folds 
rtrombin22: folds 
flagao: folds 
Uncalled bet (1616) returned to casttilho21
casttilho21 collected 177 from pot
casttilho21: doesn't show hand 
*** SUMMARY ***
Total pot 177 | Rake 0 
Seat 1: intelllect folded before Flop (didn't bet)
Seat 2: chaq*n voy folded before Flop (didn't bet)
Seat 3: flagao folded before Flop
Seat 4: casttilho21 collected (177)
Seat 5: biroxadrez folded before Flop (didn't bet)
Seat 6: thiagoflauzi (button) folded before Flop (didn't bet)
Seat 7: Paco Mechou (small blind) folded before Flop
Seat 8: rtrombin22 (big blind) folded before Flop
Seat 9: berilo.rama folded before Flop (didn't bet)



PokerStars Hand #189311057308: Tournament #2369778109, $0.23+$0.02 USD Hold'em No Limit - Level I (10/20) - 2018/07/29 20:18:33 ET
Table '2369778109 1' 9-max Seat #7 is the button
Seat 1: intelllect (1462 in chips) 
Seat 2: chaq*n voy (1499 in chips) 
Seat 3: flagao (1669 in chips) 
Seat 4: casttilho21 (1793 in chips) 
Seat 5: biroxadrez (1452 in chips) 
Seat 6: thiagoflauzi (1402 in chips) 
Seat 7: Paco Mechou (1319 in chips) 
Seat 8: rtrombin22 (1442 in chips) 
Seat 9: berilo.rama (1462 in chips) 
intelllect: posts the ante 3
chaq*n voy: posts the ante 3
flagao: posts the ante 3
casttilho21: posts the ante 3
biroxadrez: posts the ante 3
thiagoflauzi: posts the ante 3
Paco Mechou: posts the ante 3
rtrombin22: posts the ante 3
berilo.rama: posts the ante 3
rtrombin22: posts small blind 10
berilo.rama: posts big blind 20
*** HOLE CARDS ***
Dealt to flagao [Js Tc]
intelllect: folds 
chaq*n voy: folds 
flagao: folds 
casttilho21: folds 
biroxadrez: folds 
thiagoflauzi: folds 
Paco Mechou: calls 20
rtrombin22: raises 60 to 80
berilo.rama: folds 
Paco Mechou: calls 60
*** FLOP *** [2h Ts Qc]
rtrombin22: checks 
Paco Mechou: checks 
*** TURN *** [2h Ts Qc] [4s]
rtrombin22: bets 114
Paco Mechou: calls 114
*** RIVER *** [2h Ts Qc 4s] [6h]
rtrombin22: checks 
Paco Mechou: bets 200
rtrombin22: raises 459 to 659
Paco Mechou: folds 
Uncalled bet (459) returned to rtrombin22
rtrombin22 collected 835 from pot
rtrombin22: doesn't show hand 
*** SUMMARY ***
Total pot 835 | Rake 0 
Board [2h Ts Qc 4s 6h]
Seat 1: intelllect folded before Flop (didn't bet)
Seat 2: chaq*n voy folded before Flop (didn't bet)
Seat 3: flagao folded before Flop (didn't bet)
Seat 4: casttilho21 folded before Flop (didn't bet)
Seat 5: biroxadrez folded before Flop (didn't bet)
Seat 6: thiagoflauzi folded before Flop (didn't bet)
Seat 7: Paco Mechou (button) folded on the River
Seat 8: rtrombin22 (small blind) collected (835)
Seat 9: berilo.rama (big blind) folded before Flop



PokerStars Hand #189311095473: Tournament #2369778109, $0.23+$0.02 USD Hold'em No Limit - Level I (10/20) - 2018/07/29 20:19:58 ET
Table '2369778109 1' 9-max Seat #8 is the button
Seat 1: intelllect (1459 in chips) 
Seat 2: chaq*n voy (1496 in chips) 
Seat 3: flagao (1666 in chips) 
Seat 4: casttilho21 (1790 in chips) 
Seat 5: biroxadrez (1449 in chips) 
Seat 6: thiagoflauzi (1399 in chips) 
Seat 7: Paco Mechou (922 in chips) 
Seat 8: rtrombin22 (1880 in chips) 
Seat 9: berilo.rama (1439 in chips) 
intelllect: posts the ante 3
chaq*n voy: posts the ante 3
flagao: posts the ante 3
casttilho21: posts the ante 3
biroxadrez: posts the ante 3
thiagoflauzi: posts the ante 3
Paco Mechou: posts the ante 3
rtrombin22: posts the ante 3
berilo.rama: posts the ante 3
berilo.rama: posts small blind 10
intelllect: posts big blind 20
*** HOLE CARDS ***
Dealt to flagao [8d Ts]
chaq*n voy: folds 
flagao: folds 
casttilho21: calls 20
biroxadrez: folds 
thiagoflauzi: folds 
Paco Mechou: calls 20
rtrombin22: raises 80 to 100
berilo.rama: folds 
intelllect: folds 
casttilho21: folds 
Paco Mechou: calls 80
*** FLOP *** [5c 5d Tc]
Paco Mechou: checks 
rtrombin22: bets 208
Paco Mechou: folds 
Uncalled bet (208) returned to rtrombin22
rtrombin22 collected 277 from pot
rtrombin22: doesn't show hand 
*** SUMMARY ***
Total pot 277 | Rake 0 
Board [5c 5d Tc]
Seat 1: intelllect (big blind) folded before Flop
Seat 2: chaq*n voy folded before Flop (didn't bet)
Seat 3: flagao folded before Flop (didn't bet)
Seat 4: casttilho21 folded before Flop
Seat 5: biroxadrez folded before Flop (didn't bet)
Seat 6: thiagoflauzi folded before Flop (didn't bet)
Seat 7: Paco Mechou folded on the Flop
Seat 8: rtrombin22 (button) collected (277)
Seat 9: berilo.rama (small blind) folded before Flop



PokerStars Hand #189311121941: Tournament #2369778109, $0.23+$0.02 USD Hold'em No Limit - Level I (10/20) - 2018/07/29 20:20:58 ET
Table '2369778109 1' 9-max Seat #9 is the button
Seat 1: intelllect (1436 in chips) 
Seat 2: chaq*n voy (1493 in chips) 
Seat 3: flagao (1663 in chips) 
Seat 4: casttilho21 (1767 in chips) 
Seat 5: biroxadrez (1446 in chips) 
Seat 6: thiagoflauzi (1396 in chips) 
Seat 7: Paco Mechou (819 in chips) 
Seat 8: rtrombin22 (2054 in chips) 
Seat 9: berilo.rama (1426 in chips) 
intelllect: posts the ante 3
chaq*n voy: posts the ante 3
flagao: posts the ante 3
casttilho21: posts the ante 3
biroxadrez: posts the ante 3
thiagoflauzi: posts the ante 3
Paco Mechou: posts the ante 3
rtrombin22: posts the ante 3
berilo.rama: posts the ante 3
intelllect: posts small blind 10
chaq*n voy: posts big blind 20
*** HOLE CARDS ***
Dealt to flagao [7s 5h]
flagao: folds 
casttilho21: folds 
biroxadrez: folds 
thiagoflauzi: folds 
Paco Mechou: calls 20
rtrombin22: folds 
berilo.rama: folds 
intelllect: folds 
chaq*n voy: checks 
*** FLOP *** [8h 8d 9h]
chaq*n voy: checks 
Paco Mechou: bets 20
chaq*n voy: folds 
Uncalled bet (20) returned to Paco Mechou
Paco Mechou collected 77 from pot
Paco Mechou: doesn't show hand 
*** SUMMARY ***
Total pot 77 | Rake 0 
Board [8h 8d 9h]
Seat 1: intelllect (small blind) folded before Flop
Seat 2: chaq*n voy (big blind) folded on the Flop
Seat 3: flagao folded before Flop (didn't bet)
Seat 4: casttilho21 folded before Flop (didn't bet)
Seat 5: biroxadrez folded before Flop (didn't bet)
Seat 6: thiagoflauzi folded before Flop (didn't bet)
Seat 7: Paco Mechou collected (77)
Seat 8: rtrombin22 folded before Flop (didn't bet)
Seat 9: berilo.rama (button) folded before Flop (didn't bet)



PokerStars Hand #189311140649: Tournament #2369778109, $0.23+$0.02 USD Hold'em No Limit - Level II (15/30) - 2018/07/29 20:21:41 ET
Table '2369778109 1' 9-max Seat #1 is the button
Seat 1: intelllect (1423 in chips) 
Seat 2: chaq*n voy (1470 in chips) 
Seat 3: flagao (1660 in chips) 
Seat 4: casttilho21 (1764 in chips) 
Seat 5: biroxadrez (1443 in chips) 
Seat 6: thiagoflauzi (1393 in chips) 
Seat 7: Paco Mechou (873 in chips) 
Seat 8: rtrombin22 (2051 in chips) 
Seat 9: berilo.rama (1423 in chips) 
intelllect: posts the ante 4
chaq*n voy: posts the ante 4
flagao: posts the ante 4
casttilho21: posts the ante 4
biroxadrez: posts the ante 4
thiagoflauzi: posts the ante 4
Paco Mechou: posts the ante 4
rtrombin22: posts the ante 4
berilo.rama: posts the ante 4
chaq*n voy: posts small blind 15
flagao: posts big blind 30
*** HOLE CARDS ***
Dealt to flagao [5h Kc]
casttilho21: raises 1730 to 1760 and is all-in
biroxadrez: folds 
thiagoflauzi: folds 
Paco Mechou: folds 
rtrombin22: folds 
berilo.rama: folds 
intelllect: folds 
chaq*n voy: folds 
flagao: folds 
Uncalled bet (1730) returned to casttilho21
casttilho21 collected 111 from pot
casttilho21: doesn't show hand 
*** SUMMARY ***
Total pot 111 | Rake 0 
Seat 1: intelllect (button) folded before Flop (didn't bet)
Seat 2: chaq*n voy (small blind) folded before Flop
Seat 3: flagao (big blind) folded before Flop
Seat 4: casttilho21 collected (111)
Seat 5: biroxadrez folded before Flop (didn't bet)
Seat 6: thiagoflauzi folded before Flop (didn't bet)
Seat 7: Paco Mechou folded before Flop (didn't bet)
Seat 8: rtrombin22 folded before Flop (didn't bet)
Seat 9: berilo.rama folded before Flop (didn't bet)



PokerStars Hand #189311158590: Tournament #2369778109, $0.23+$0.02 USD Hold'em No Limit - Level II (15/30) - 2018/07/29 20:22:22 ET
Table '2369778109 1' 9-max Seat #2 is the button
Seat 1: intelllect (1419 in chips) 
Seat 2: chaq*n voy (1451 in chips) 
Seat 3: flagao (1626 in chips) 
Seat 4: casttilho21 (1841 in chips) 
Seat 5: biroxadrez (1439 in chips) 
Seat 6: thiagoflauzi (1389 in chips) 
Seat 7: Paco Mechou (869 in chips) 
Seat 8: rtrombin22 (2047 in chips) 
Seat 9: berilo.rama (1419 in chips) 
intelllect: posts the ante 4
chaq*n voy: posts the ante 4
flagao: posts the ante 4
casttilho21: posts the ante 4
biroxadrez: posts the ante 4
thiagoflauzi: posts the ante 4
Paco Mechou: posts the ante 4
rtrombin22: posts the ante 4
berilo.rama: posts the ante 4
flagao: posts small blind 15
casttilho21: posts big blind 30
*** HOLE CARDS ***
Dealt to flagao [3s 9d]
biroxadrez: folds 
thiagoflauzi: calls 30
Paco Mechou: calls 30
rtrombin22: calls 30
berilo.rama: raises 1385 to 1415 and is all-in
intelllect: folds 
chaq*n voy: folds 
flagao: folds 
casttilho21: folds 
thiagoflauzi: folds 
Paco Mechou: folds 
rtrombin22: folds 
Uncalled bet (1385) returned to berilo.rama
berilo.rama collected 201 from pot
*** SUMMARY ***
Total pot 201 | Rake 0 
Seat 1: intelllect folded before Flop (didn't bet)
Seat 2: chaq*n voy (button) folded before Flop (didn't bet)
Seat 3: flagao (small blind) folded before Flop
Seat 4: casttilho21 (big blind) folded before Flop
Seat 5: biroxadrez folded before Flop (didn't bet)
Seat 6: thiagoflauzi folded before Flop
Seat 7: Paco Mechou folded before Flop
Seat 8: rtrombin22 folded before Flop
Seat 9: berilo.rama collected (201)



PokerStars Hand #189311179318: Tournament #2369778109, $0.23+$0.02 USD Hold'em No Limit - Level II (15/30) - 2018/07/29 20:23:09 ET
Table '2369778109 1' 9-max Seat #3 is the button
Seat 1: intelllect (1415 in chips) 
Seat 2: chaq*n voy (1447 in chips) 
Seat 3: flagao (1607 in chips) 
Seat 4: casttilho21 (1807 in chips) 
Seat 5: biroxadrez (1435 in chips) 
Seat 6: thiagoflauzi (1355 in chips) 
Seat 7: Paco Mechou (835 in chips) 
Seat 8: rtrombin22 (2013 in chips) 
Seat 9: berilo.rama (1586 in chips) 
intelllect: posts the ante 4
chaq*n voy: posts the ante 4
flagao: posts the ante 4
casttilho21: posts the ante 4
biroxadrez: posts the ante 4
thiagoflauzi: posts the ante 4
Paco Mechou: posts the ante 4
rtrombin22: posts the ante 4
berilo.rama: posts the ante 4
casttilho21: posts small blind 15
biroxadrez: posts big blind 30
*** HOLE CARDS ***
Dealt to flagao [5d 8d]
thiagoflauzi: folds 
Paco Mechou: calls 30
rtrombin22: folds 
berilo.rama: folds 
intelllect: calls 30
chaq*n voy: calls 30
flagao: folds 
casttilho21: calls 15
biroxadrez: checks 
*** FLOP *** [6h Kd Jc]
casttilho21: bets 90
biroxadrez: folds 
Paco Mechou: folds 
intelllect: folds 
chaq*n voy: calls 90
*** TURN *** [6h Kd Jc] [Jh]
casttilho21: bets 150
chaq*n voy: folds 
Uncalled bet (150) returned to casttilho21
casttilho21 collected 366 from pot
casttilho21: doesn't show hand 
*** SUMMARY ***
Total pot 366 | Rake 0 
Board [6h Kd Jc Jh]
Seat 1: intelllect folded on the Flop
Seat 2: chaq*n voy folded on the Turn
Seat 3: flagao (button) folded before Flop (didn't bet)
Seat 4: casttilho21 (small blind) collected (366)
Seat 5: biroxadrez (big blind) folded on the Flop
Seat 6: thiagoflauzi folded before Flop (didn't bet)
Seat 7: Paco Mechou folded on the Flop
Seat 8: rtrombin22 folded before Flop (didn't bet)
Seat 9: berilo.rama folded before Flop (didn't bet)



PokerStars Hand #189311223281: Tournament #2369778109, $0.23+$0.02 USD Hold'em No Limit - Level II (15/30) - 2018/07/29 20:24:50 ET
Table '2369778109 1' 9-max Seat #4 is the button
Seat 1: intelllect (1381 in chips) 
Seat 3: flagao (1603 in chips) 
Seat 4: casttilho21 (2049 in chips) 
Seat 5: biroxadrez (1401 in chips) 
Seat 6: thiagoflauzi (1351 in chips) 
Seat 7: Paco Mechou (801 in chips) 
Seat 8: rtrombin22 (2009 in chips) 
Seat 9: berilo.rama (1582 in chips) 
intelllect: posts the ante 4
flagao: posts the ante 4
casttilho21: posts the ante 4
biroxadrez: posts the ante 4
thiagoflauzi: posts the ante 4
Paco Mechou: posts the ante 4
rtrombin22: posts the ante 4
berilo.rama: posts the ante 4
biroxadrez: posts small blind 15
thiagoflauzi: posts big blind 30
*** HOLE CARDS ***
Dealt to flagao [6h Ks]
Paco Mechou: calls 30
rtrombin22: folds 
berilo.rama: folds 
intelllect: folds 
flagao: folds 
casttilho21: folds 
biroxadrez: calls 15
thiagoflauzi: raises 60 to 90
Paco Mechou: calls 60
biroxadrez: folds 
*** FLOP *** [7h 8s 4c]
thiagoflauzi: bets 121
Paco Mechou: calls 121
*** TURN *** [7h 8s 4c] [2h]
thiagoflauzi: checks 
Paco Mechou: checks 
*** RIVER *** [7h 8s 4c 2h] [Jc]
thiagoflauzi: bets 242
Paco Mechou: calls 242
*** SHOW DOWN ***
thiagoflauzi: shows [Kh Ac] (high card Ace)
Paco Mechou: shows [Jd 7d] (two pair, Jacks and Sevens)
Paco Mechou collected 968 from pot
*** SUMMARY ***
Total pot 968 | Rake 0 
Board [7h 8s 4c 2h Jc]
Seat 1: intelllect folded before Flop (didn't bet)
Seat 3: flagao folded before Flop (didn't bet)
Seat 4: casttilho21 (button) folded before Flop (didn't bet)
Seat 5: biroxadrez (small blind) folded before Flop
Seat 6: thiagoflauzi (big blind) showed [Kh Ac] and lost with high card Ace
Seat 7: Paco Mechou showed [Jd 7d] and won (968) with two pair, Jacks and Sevens
Seat 8: rtrombin22 folded before Flop (didn't bet)
Seat 9: berilo.rama folded before Flop (didn't bet)



PokerStars Hand #189311261159: Tournament #2369778109, $0.23+$0.02 USD Hold'em No Limit - Level II (15/30) - 2018/07/29 20:26:17 ET
Table '2369778109 1' 9-max Seat #5 is the button
Seat 1: intelllect (1377 in chips) 
Seat 3: flagao (1599 in chips) 
Seat 4: casttilho21 (2045 in chips) 
Seat 5: biroxadrez (1367 in chips) 
Seat 6: thiagoflauzi (894 in chips) 
Seat 7: Paco Mechou (1312 in chips) 
Seat 8: rtrombin22 (2005 in chips) 
Seat 9: berilo.rama (1578 in chips) 
intelllect: posts the ante 4
flagao: posts the ante 4
casttilho21: posts the ante 4
biroxadrez: posts the ante 4
thiagoflauzi: posts the ante 4
Paco Mechou: posts the ante 4
rtrombin22: posts the ante 4
berilo.rama: posts the ante 4
thiagoflauzi: posts small blind 15
Paco Mechou: posts big blind 30
*** HOLE CARDS ***
Dealt to flagao [2h Kd]
rtrombin22: folds 
berilo.rama: folds 
intelllect: raises 45 to 75
flagao: folds 
casttilho21: calls 75
biroxadrez: folds 
thiagoflauzi: calls 60
Paco Mechou: calls 45
*** FLOP *** [3c 2c 2d]
thiagoflauzi: checks 
Paco Mechou: checks 
intelllect: checks 
casttilho21: checks 
*** TURN *** [3c 2c 2d] [5c]
thiagoflauzi: checks 
Paco Mechou: bets 60
intelllect: folds 
casttilho21: calls 60
thiagoflauzi: folds 
*** RIVER *** [3c 2c 2d 5c] [9h]
Paco Mechou: bets 120
casttilho21: folds [Ks]
Uncalled bet (120) returned to Paco Mechou
Paco Mechou collected 452 from pot
Paco Mechou: doesn't show hand 
*** SUMMARY ***
Total pot 452 | Rake 0 
Board [3c 2c 2d 5c 9h]
Seat 1: intelllect folded on the Turn
Seat 3: flagao folded before Flop (didn't bet)
Seat 4: casttilho21 folded on the River
Seat 5: biroxadrez (button) folded before Flop (didn't bet)
Seat 6: thiagoflauzi (small blind) folded on the Turn
Seat 7: Paco Mechou (big blind) collected (452)
Seat 8: rtrombin22 folded before Flop (didn't bet)
Seat 9: berilo.rama folded before Flop (didn't bet)



PokerStars Hand #189311309449: Tournament #2369778109, $0.23+$0.02 USD Hold'em No Limit - Level II (15/30) - 2018/07/29 20:28:10 ET
Table '2369778109 1' 9-max Seat #6 is the button
Seat 1: intelllect (1298 in chips) 
Seat 3: flagao (1595 in chips) 
Seat 4: casttilho21 (1906 in chips) 
Seat 5: biroxadrez (1363 in chips) 
Seat 6: thiagoflauzi (815 in chips) 
Seat 7: Paco Mechou (1625 in chips) 
Seat 8: rtrombin22 (2001 in chips) 
Seat 9: berilo.rama (1574 in chips) 
intelllect: posts the ante 4
flagao: posts the ante 4
casttilho21: posts the ante 4
biroxadrez: posts the ante 4
thiagoflauzi: posts the ante 4
Paco Mechou: posts the ante 4
rtrombin22: posts the ante 4
berilo.rama: posts the ante 4
Paco Mechou: posts small blind 15
rtrombin22: posts big blind 30
*** HOLE CARDS ***
Dealt to flagao [9s Ah]
berilo.rama: folds 
intelllect: folds 
flagao: raises 60 to 90
casttilho21: folds 
biroxadrez: folds 
thiagoflauzi: folds 
Paco Mechou: calls 75
rtrombin22: calls 60
*** FLOP *** [5s 6h Js]
Paco Mechou: checks 
rtrombin22: checks 
flagao: bets 180
Paco Mechou: folds 
rtrombin22: folds 
Uncalled bet (180) returned to flagao
flagao collected 302 from pot
flagao: doesn't show hand 
*** SUMMARY ***
Total pot 302 | Rake 0 
Board [5s 6h Js]
Seat 1: intelllect folded before Flop (didn't bet)
Seat 3: flagao collected (302)
Seat 4: casttilho21 folded before Flop (didn't bet)
Seat 5: biroxadrez folded before Flop (didn't bet)
Seat 6: thiagoflauzi (button) folded before Flop (didn't bet)
Seat 7: Paco Mechou (small blind) folded on the Flop
Seat 8: rtrombin22 (big blind) folded on the Flop
Seat 9: berilo.rama folded before Flop (didn't bet)



PokerStars Hand #189311334701: Tournament #2369778109, $0.23+$0.02 USD Hold'em No Limit - Level II (15/30) - 2018/07/29 20:29:09 ET
Table '2369778109 1' 9-max Seat #7 is the button
Seat 1: intelllect (1294 in chips) 
Seat 3: flagao (1803 in chips) 
Seat 4: casttilho21 (1902 in chips) 
Seat 5: biroxadrez (1359 in chips) 
Seat 6: thiagoflauzi (811 in chips) 
Seat 7: Paco Mechou (1531 in chips) 
Seat 8: rtrombin22 (1907 in chips) 
Seat 9: berilo.rama (1570 in chips) 
intelllect: posts the ante 4
flagao: posts the ante 4
casttilho21: posts the ante 4
biroxadrez: posts the ante 4
thiagoflauzi: posts the ante 4
Paco Mechou: posts the ante 4
rtrombin22: posts the ante 4
berilo.rama: posts the ante 4
rtrombin22: posts small blind 15
berilo.rama: posts big blind 30
*** HOLE CARDS ***
Dealt to flagao [8h Jd]
intelllect: folds 
flagao: folds 
casttilho21: folds 
biroxadrez: folds 
thiagoflauzi: folds 
Paco Mechou: calls 30
rtrombin22: calls 15
berilo.rama: checks 
*** FLOP *** [2c 9d 6c]
rtrombin22: checks 
berilo.rama: checks 
Paco Mechou: bets 30
rtrombin22: calls 30
berilo.rama: calls 30
*** TURN *** [2c 9d 6c] [7d]
rtrombin22: checks 
berilo.rama: checks 
Paco Mechou: bets 90
rtrombin22: calls 90
berilo.rama: folds 
*** RIVER *** [2c 9d 6c 7d] [9s]
rtrombin22: checks 
Paco Mechou: bets 120
rtrombin22: calls 120
*** SHOW DOWN ***
Paco Mechou: shows [9h Ad] (three of a kind, Nines)
rtrombin22: mucks hand 
Paco Mechou collected 632 from pot
*** SUMMARY ***
Total pot 632 | Rake 0 
Board [2c 9d 6c 7d 9s]
Seat 1: intelllect folded before Flop (didn't bet)
Seat 3: flagao folded before Flop (didn't bet)
Seat 4: casttilho21 folded before Flop (didn't bet)
Seat 5: biroxadrez folded before Flop (didn't bet)
Seat 6: thiagoflauzi folded before Flop (didn't bet)
Seat 7: Paco Mechou (button) showed [9h Ad] and won (632) with three of a kind, Nines
Seat 8: rtrombin22 (small blind) mucked [Th 7h]
Seat 9: berilo.rama (big blind) folded on the Turn



PokerStars Hand #189311368835: Tournament #2369778109, $0.23+$0.02 USD Hold'em No Limit - Level II (15/30) - 2018/07/29 20:30:29 ET
Table '2369778109 1' 9-max Seat #8 is the button
Seat 1: intelllect (1290 in chips) 
Seat 3: flagao (1799 in chips) 
Seat 4: casttilho21 (1898 in chips) 
Seat 5: biroxadrez (1355 in chips) 
Seat 6: thiagoflauzi (807 in chips) 
Seat 7: Paco Mechou (1889 in chips) 
Seat 8: rtrombin22 (1633 in chips) 
Seat 9: berilo.rama (1506 in chips) 
intelllect: posts the ante 4
flagao: posts the ante 4
casttilho21: posts the ante 4
biroxadrez: posts the ante 4
thiagoflauzi: posts the ante 4
Paco Mechou: posts the ante 4
rtrombin22: posts the ante 4
berilo.rama: posts the ante 4
berilo.rama: posts small blind 15
intelllect: posts big blind 30
*** HOLE CARDS ***
Dealt to flagao [8c 9c]
flagao: raises 30 to 60
casttilho21: folds 
biroxadrez: calls 60
thiagoflauzi: folds 
Paco Mechou: calls 60
rtrombin22: calls 60
berilo.rama: folds 
intelllect: folds 
*** FLOP *** [8s As 2d]
flagao: checks 
biroxadrez: checks 
Paco Mechou: checks 
rtrombin22: bets 174
flagao: folds 
biroxadrez: folds 
Paco Mechou: folds 
Uncalled bet (174) returned to rtrombin22
rtrombin22 collected 317 from pot
rtrombin22: doesn't show hand 
*** SUMMARY ***
Total pot 317 | Rake 0 
Board [8s As 2d]
Seat 1: intelllect (big blind) folded before Flop
Seat 3: flagao folded on the Flop
Seat 4: casttilho21 folded before Flop (didn't bet)
Seat 5: biroxadrez folded on the Flop
Seat 6: thiagoflauzi folded before Flop (didn't bet)
Seat 7: Paco Mechou folded on the Flop
Seat 8: rtrombin22 (button) collected (317)
Seat 9: berilo.rama (small blind) folded before Flop



PokerStars Hand #189311413519: Tournament #2369778109, $0.23+$0.02 USD Hold'em No Limit - Level III (25/50) - 2018/07/29 20:31:54 ET
Table '2369778109 1' 9-max Seat #9 is the button
Seat 1: intelllect (1256 in chips) 
Seat 3: flagao (1735 in chips) 
Seat 4: casttilho21 (1894 in chips) 
Seat 5: biroxadrez (1291 in chips) 
Seat 6: thiagoflauzi (803 in chips) 
Seat 7: Paco Mechou (1825 in chips) 
Seat 8: rtrombin22 (1886 in chips) 
Seat 9: berilo.rama (1487 in chips) 
intelllect: posts the ante 6
flagao: posts the ante 6
casttilho21: posts the ante 6
biroxadrez: posts the ante 6
thiagoflauzi: posts the ante 6
Paco Mechou: posts the ante 6
rtrombin22: posts the ante 6
berilo.rama: posts the ante 6
intelllect: posts small blind 25
flagao: posts big blind 50
*** HOLE CARDS ***
Dealt to flagao [8d Td]
casttilho21: folds 
biroxadrez: folds 
thiagoflauzi: folds 
Paco Mechou: calls 50
rtrombin22: folds 
berilo.rama: folds 
intelllect: raises 100 to 150
flagao: folds 
Paco Mechou: calls 100
*** FLOP *** [6c 2d 4s]
intelllect: bets 100
Paco Mechou: calls 100
*** TURN *** [6c 2d 4s] [9h]
intelllect: checks 
Paco Mechou: bets 100
intelllect: calls 100
*** RIVER *** [6c 2d 4s 9h] [Js]
intelllect: checks 
Paco Mechou: bets 200
intelllect: folds 
Uncalled bet (200) returned to Paco Mechou
Paco Mechou collected 798 from pot
Paco Mechou: doesn't show hand 
*** SUMMARY ***
Total pot 798 | Rake 0 
Board [6c 2d 4s 9h Js]
Seat 1: intelllect (small blind) folded on the River
Seat 3: flagao (big blind) folded before Flop
Seat 4: casttilho21 folded before Flop (didn't bet)
Seat 5: biroxadrez folded before Flop (didn't bet)
Seat 6: thiagoflauzi folded before Flop (didn't bet)
Seat 7: Paco Mechou collected (798)
Seat 8: rtrombin22 folded before Flop (didn't bet)
Seat 9: berilo.rama (button) folded before Flop (didn't bet)



PokerStars Hand #189311451841: Tournament #2369778109, $0.23+$0.02 USD Hold'em No Limit - Level III (25/50) - 2018/07/29 20:33:25 ET
Table '2369778109 1' 9-max Seat #1 is the button
Seat 1: intelllect (900 in chips) 
Seat 3: flagao (1679 in chips) 
Seat 4: casttilho21 (1888 in chips) 
Seat 5: biroxadrez (1285 in chips) 
Seat 6: thiagoflauzi (797 in chips) 
Seat 7: Paco Mechou (2267 in chips) 
Seat 8: rtrombin22 (1880 in chips) 
Seat 9: berilo.rama (1481 in chips) 
intelllect: posts the ante 6
flagao: posts the ante 6
casttilho21: posts the ante 6
biroxadrez: posts the ante 6
thiagoflauzi: posts the ante 6
Paco Mechou: posts the ante 6
rtrombin22: posts the ante 6
berilo.rama: posts the ante 6
flagao: posts small blind 25
casttilho21: posts big blind 50
*** HOLE CARDS ***
Dealt to flagao [7s Jh]
biroxadrez: folds 
thiagoflauzi: folds 
Paco Mechou: calls 50
rtrombin22: calls 50
berilo.rama: folds 
intelllect: folds 
flagao: folds 
casttilho21: raises 50 to 100
Paco Mechou: calls 50
rtrombin22: calls 50
*** FLOP *** [9s As Kh]
casttilho21: bets 200
Paco Mechou: folds 
rtrombin22: calls 200
*** TURN *** [9s As Kh] [5d]
casttilho21: bets 250
rtrombin22: calls 250
*** RIVER *** [9s As Kh 5d] [Ac]
casttilho21: checks 
rtrombin22: checks 
*** SHOW DOWN ***
casttilho21: shows [Ts Tc] (two pair, Aces and Tens)
rtrombin22: shows [Ks Qd] (two pair, Aces and Kings)
rtrombin22 collected 1273 from pot
*** SUMMARY ***
Total pot 1273 | Rake 0 
Board [9s As Kh 5d Ac]
Seat 1: intelllect (button) folded before Flop (didn't bet)
Seat 3: flagao (small blind) folded before Flop
Seat 4: casttilho21 (big blind) showed [Ts Tc] and lost with two pair, Aces and Tens
Seat 5: biroxadrez folded before Flop (didn't bet)
Seat 6: thiagoflauzi folded before Flop (didn't bet)
Seat 7: Paco Mechou folded on the Flop
Seat 8: rtrombin22 showed [Ks Qd] and won (1273) with two pair, Aces and Kings
Seat 9: berilo.rama folded before Flop (didn't bet)



PokerStars Hand #189311494962: Tournament #2369778109, $0.23+$0.02 USD Hold'em No Limit - Level III (25/50) - 2018/07/29 20:35:06 ET
Table '2369778109 1' 9-max Seat #3 is the button
Seat 1: intelllect (894 in chips) 
Seat 3: flagao (1648 in chips) 
Seat 4: casttilho21 (1332 in chips) 
Seat 5: biroxadrez (1279 in chips) 
Seat 6: thiagoflauzi (791 in chips) 
Seat 7: Paco Mechou (2161 in chips) 
Seat 8: rtrombin22 (2597 in chips) 
Seat 9: berilo.rama (1475 in chips) 
intelllect: posts the ante 6
flagao: posts the ante 6
casttilho21: posts the ante 6
biroxadrez: posts the ante 6
thiagoflauzi: posts the ante 6
Paco Mechou: posts the ante 6
rtrombin22: posts the ante 6
berilo.rama: posts the ante 6
casttilho21: posts small blind 25
biroxadrez: posts big blind 50
*** HOLE CARDS ***
Dealt to flagao [3h Ts]
thiagoflauzi: folds 
Paco Mechou: calls 50
rtrombin22: folds 
berilo.rama: folds 
intelllect: folds 
flagao: folds 
casttilho21: folds 
biroxadrez: checks 
*** FLOP *** [4h Qh Js]
biroxadrez: bets 50
Paco Mechou: calls 50
*** TURN *** [4h Qh Js] [7h]
biroxadrez: bets 150
Paco Mechou: calls 150
*** RIVER *** [4h Qh Js 7h] [8c]
biroxadrez: bets 150
Paco Mechou: calls 150
*** SHOW DOWN ***
biroxadrez: shows [Qd As] (a pair of Queens)
Paco Mechou: shows [4s 4d] (three of a kind, Fours)
Paco Mechou collected 873 from pot
*** SUMMARY ***
Total pot 873 | Rake 0 
Board [4h Qh Js 7h 8c]
Seat 1: intelllect folded before Flop (didn't bet)
Seat 3: flagao (button) folded before Flop (didn't bet)
Seat 4: casttilho21 (small blind) folded before Flop
Seat 5: biroxadrez (big blind) showed [Qd As] and lost with a pair of Queens
Seat 6: thiagoflauzi folded before Flop (didn't bet)
Seat 7: Paco Mechou showed [4s 4d] and won (873) with three of a kind, Fours
Seat 8: rtrombin22 folded before Flop (didn't bet)
Seat 9: berilo.rama folded before Flop (didn't bet)



PokerStars Hand #189311517456: Tournament #2369778109, $0.23+$0.02 USD Hold'em No Limit - Level III (25/50) - 2018/07/29 20:36:00 ET
Table '2369778109 1' 9-max Seat #4 is the button
Seat 1: intelllect (888 in chips) 
Seat 3: flagao (1642 in chips) 
Seat 4: casttilho21 (1301 in chips) 
Seat 5: biroxadrez (873 in chips) 
Seat 6: thiagoflauzi (785 in chips) 
Seat 7: Paco Mechou (2628 in chips) 
Seat 8: rtrombin22 (2591 in chips) 
Seat 9: berilo.rama (1469 in chips) 
intelllect: posts the ante 6
flagao: posts the ante 6
casttilho21: posts the ante 6
biroxadrez: posts the ante 6
thiagoflauzi: posts the ante 6
Paco Mechou: posts the ante 6
rtrombin22: posts the ante 6
berilo.rama: posts the ante 6
biroxadrez: posts small blind 25
thiagoflauzi: posts big blind 50
*** HOLE CARDS ***
Dealt to flagao [Td Ad]
Paco Mechou: calls 50
rtrombin22: folds 
berilo.rama has timed out
berilo.rama: folds 
berilo.rama is sitting out
intelllect: folds 
flagao: raises 100 to 150
casttilho21: calls 150
biroxadrez: folds 
thiagoflauzi: folds 
Paco Mechou: calls 100
*** FLOP *** [5d Kc 2d]
Paco Mechou: checks 
flagao: bets 300
casttilho21: calls 300
Paco Mechou: folds 
*** TURN *** [5d Kc 2d] [3d]
flagao: checks 
casttilho21: bets 845 and is all-in
flagao: calls 845
*** RIVER *** [5d Kc 2d 3d] [Jc]
*** SHOW DOWN ***
flagao: shows [Td Ad] (a flush, Ace high)
casttilho21: shows [Kd Jh] (two pair, Kings and Jacks)
flagao collected 2863 from pot
casttilho21 finished the tournament in 36th place
*** SUMMARY ***
Total pot 2863 | Rake 0 
Board [5d Kc 2d 3d Jc]
Seat 1: intelllect folded before Flop (didn't bet)
Seat 3: flagao showed [Td Ad] and won (2863) with a flush, Ace high
Seat 4: casttilho21 (button) showed [Kd Jh] and lost with two pair, Kings and Jacks
Seat 5: biroxadrez (small blind) folded before Flop
Seat 6: thiagoflauzi (big blind) folded before Flop
Seat 7: Paco Mechou folded on the Flop
Seat 8: rtrombin22 folded before Flop (didn't bet)
Seat 9: berilo.rama folded before Flop (didn't bet)



PokerStars Hand #189311576773: Tournament #2369778109, $0.23+$0.02 USD Hold'em No Limit - Level III (25/50) - 2018/07/29 20:38:23 ET
Table '2369778109 1' 9-max Seat #5 is the button
Seat 1: intelllect (882 in chips) 
Seat 2: ramigrilo (2596 in chips) 
Seat 3: flagao (3204 in chips) 
Seat 5: biroxadrez (842 in chips) 
Seat 6: thiagoflauzi (729 in chips) 
Seat 7: Paco Mechou (2472 in chips) 
Seat 8: rtrombin22 (2585 in chips) 
Seat 9: berilo.rama (1463 in chips) is sitting out
intelllect: posts the ante 6
ramigrilo: posts the ante 6
flagao: posts the ante 6
biroxadrez: posts the ante 6
thiagoflauzi: posts the ante 6
Paco Mechou: posts the ante 6
rtrombin22: posts the ante 6
berilo.rama: posts the ante 6
thiagoflauzi: posts small blind 25
Paco Mechou: posts big blind 50
*** HOLE CARDS ***
Dealt to flagao [7s Kh]
rtrombin22: folds 
berilo.rama: folds 
intelllect: folds 
ramigrilo: folds 
flagao: folds 
biroxadrez: calls 50
thiagoflauzi: calls 25
Paco Mechou: checks 
*** FLOP *** [4s 8c 3s]
thiagoflauzi: checks 
Paco Mechou: bets 50
biroxadrez: calls 50
thiagoflauzi: folds 
*** TURN *** [4s 8c 3s] [Qc]
Paco Mechou: bets 50
biroxadrez: calls 50
*** RIVER *** [4s 8c 3s Qc] [2c]
Paco Mechou: bets 150
biroxadrez: folds 
Uncalled bet (150) returned to Paco Mechou
Paco Mechou collected 398 from pot
Paco Mechou: doesn't show hand 
*** SUMMARY ***
Total pot 398 | Rake 0 
Board [4s 8c 3s Qc 2c]
Seat 1: intelllect folded before Flop (didn't bet)
Seat 2: ramigrilo folded before Flop (didn't bet)
Seat 3: flagao folded before Flop (didn't bet)
Seat 5: biroxadrez (button) folded on the River
Seat 6: thiagoflauzi (small blind) folded on the Flop
Seat 7: Paco Mechou (big blind) collected (398)
Seat 8: rtrombin22 folded before Flop (didn't bet)
Seat 9: berilo.rama folded before Flop (didn't bet)



PokerStars Hand #189311602600: Tournament #2369778109, $0.23+$0.02 USD Hold'em No Limit - Level III (25/50) - 2018/07/29 20:39:26 ET
Table '2369778109 1' 9-max Seat #6 is the button
Seat 1: intelllect (876 in chips) 
Seat 2: ramigrilo (2590 in chips) 
Seat 3: flagao (3198 in chips) 
Seat 5: biroxadrez (686 in chips) 
Seat 6: thiagoflauzi (673 in chips) 
Seat 7: Paco Mechou (2714 in chips) 
Seat 8: rtrombin22 (2579 in chips) 
Seat 9: berilo.rama (1457 in chips) is sitting out
intelllect: posts the ante 6
ramigrilo: posts the ante 6
flagao: posts the ante 6
biroxadrez: posts the ante 6
thiagoflauzi: posts the ante 6
Paco Mechou: posts the ante 6
rtrombin22: posts the ante 6
berilo.rama: posts the ante 6
Paco Mechou: posts small blind 25
rtrombin22: posts big blind 50
*** HOLE CARDS ***
Dealt to flagao [Td 9h]
berilo.rama: folds 
intelllect: folds 
ramigrilo: folds 
flagao: folds 
biroxadrez: folds 
thiagoflauzi: folds 
Paco Mechou: calls 25
rtrombin22: checks 
*** FLOP *** [5s 4d 9d]
Paco Mechou: bets 50
rtrombin22: calls 50
*** TURN *** [5s 4d 9d] [Ad]
Paco Mechou: bets 50
rtrombin22: folds 
Uncalled bet (50) returned to Paco Mechou
Paco Mechou collected 248 from pot
Paco Mechou: doesn't show hand 
*** SUMMARY ***
Total pot 248 | Rake 0 
Board [5s 4d 9d Ad]
Seat 1: intelllect folded before Flop (didn't bet)
Seat 2: ramigrilo folded before Flop (didn't bet)
Seat 3: flagao folded before Flop (didn't bet)
Seat 5: biroxadrez folded before Flop (didn't bet)
Seat 6: thiagoflauzi (button) folded before Flop (didn't bet)
Seat 7: Paco Mechou (small blind) collected (248)
Seat 8: rtrombin22 (big blind) folded on the Turn
Seat 9: berilo.rama folded before Flop (didn't bet)



PokerStars Hand #189311623370: Tournament #2369778109, $0.23+$0.02 USD Hold'em No Limit - Level III (25/50) - 2018/07/29 20:40:17 ET
Table '2369778109 1' 9-max Seat #7 is the button
Seat 1: intelllect (870 in chips) 
Seat 2: ramigrilo (2584 in chips) 
Seat 3: flagao (3192 in chips) 
Seat 5: biroxadrez (680 in chips) 
Seat 6: thiagoflauzi (667 in chips) 
Seat 7: Paco Mechou (2856 in chips) 
Seat 8: rtrombin22 (2473 in chips) 
Seat 9: berilo.rama (1451 in chips) is sitting out
intelllect: posts the ante 6
ramigrilo: posts the ante 6
flagao: posts the ante 6
biroxadrez: posts the ante 6
thiagoflauzi: posts the ante 6
Paco Mechou: posts the ante 6
rtrombin22: posts the ante 6
berilo.rama: posts the ante 6
rtrombin22: posts small blind 25
berilo.rama: posts big blind 50
*** HOLE CARDS ***
Dealt to flagao [7s 5d]
intelllect: raises 50 to 100
ramigrilo: folds 
flagao: folds 
biroxadrez: folds 
thiagoflauzi: folds 
Paco Mechou: calls 100
rtrombin22: folds 
berilo.rama: folds 
*** FLOP *** [7h 7c Ac]
intelllect: bets 81
Paco Mechou: calls 81
*** TURN *** [7h 7c Ac] [8d]
intelllect: checks 
Paco Mechou: bets 100
intelllect: calls 100
*** RIVER *** [7h 7c Ac 8d] [4h]
intelllect: checks 
Paco Mechou: bets 150
intelllect: calls 150
*** SHOW DOWN ***
Paco Mechou: shows [3h Qh] (a pair of Sevens)
intelllect: shows [Tc Ts] (two pair, Tens and Sevens)
intelllect collected 985 from pot
*** SUMMARY ***
Total pot 985 | Rake 0 
Board [7h 7c Ac 8d 4h]
Seat 1: intelllect showed [Tc Ts] and won (985) with two pair, Tens and Sevens
Seat 2: ramigrilo folded before Flop (didn't bet)
Seat 3: flagao folded before Flop (didn't bet)
Seat 5: biroxadrez folded before Flop (didn't bet)
Seat 6: thiagoflauzi folded before Flop (didn't bet)
Seat 7: Paco Mechou (button) showed [3h Qh] and lost with a pair of Sevens
Seat 8: rtrombin22 (small blind) folded before Flop
Seat 9: berilo.rama (big blind) folded before Flop



PokerStars Hand #189311648489: Tournament #2369778109, $0.23+$0.02 USD Hold'em No Limit - Level III (25/50) - 2018/07/29 20:41:19 ET
Table '2369778109 1' 9-max Seat #8 is the button
Seat 1: intelllect (1418 in chips) 
Seat 2: ramigrilo (2578 in chips) 
Seat 3: flagao (3186 in chips) 
Seat 5: biroxadrez (674 in chips) 
Seat 6: thiagoflauzi (661 in chips) 
Seat 7: Paco Mechou (2419 in chips) 
Seat 8: rtrombin22 (2442 in chips) 
Seat 9: berilo.rama (1395 in chips) is sitting out
intelllect: posts the ante 6
ramigrilo: posts the ante 6
flagao: posts the ante 6
biroxadrez: posts the ante 6
thiagoflauzi: posts the ante 6
Paco Mechou: posts the ante 6
rtrombin22: posts the ante 6
berilo.rama: posts the ante 6
berilo.rama: posts small blind 25
intelllect: posts big blind 50
*** HOLE CARDS ***
Dealt to flagao [3h Tc]
ramigrilo: raises 100 to 150
flagao: folds 
biroxadrez: folds 
thiagoflauzi: folds 
Paco Mechou: calls 150
rtrombin22: folds 
berilo.rama: folds 
intelllect: calls 100
*** FLOP *** [Qs Ac 2s]
intelllect: checks 
ramigrilo: bets 100
Paco Mechou: calls 100
intelllect: folds 
*** TURN *** [Qs Ac 2s] [6s]
ramigrilo: bets 100
Paco Mechou: calls 100
*** RIVER *** [Qs Ac 2s 6s] [4d]
ramigrilo: checks 
Paco Mechou: checks 
*** SHOW DOWN ***
ramigrilo: shows [Ks As] (a flush, Ace high)
Paco Mechou: mucks hand 
ramigrilo collected 923 from pot
*** SUMMARY ***
Total pot 923 | Rake 0 
Board [Qs Ac 2s 6s 4d]
Seat 1: intelllect (big blind) folded on the Flop
Seat 2: ramigrilo showed [Ks As] and won (923) with a flush, Ace high
Seat 3: flagao folded before Flop (didn't bet)
Seat 5: biroxadrez folded before Flop (didn't bet)
Seat 6: thiagoflauzi folded before Flop (didn't bet)
Seat 7: Paco Mechou mucked [Td Qh]
Seat 8: rtrombin22 (button) folded before Flop (didn't bet)
Seat 9: berilo.rama (small blind) folded before Flop



PokerStars Hand #189311685068: Tournament #2369778109, $0.23+$0.02 USD Hold'em No Limit - Level IV (40/80) - 2018/07/29 20:42:50 ET
Table '2369778109 1' 9-max Seat #9 is the button
Seat 1: intelllect (1262 in chips) 
Seat 2: ramigrilo (3145 in chips) 
Seat 3: flagao (3180 in chips) 
Seat 5: biroxadrez (668 in chips) 
Seat 6: thiagoflauzi (655 in chips) 
Seat 7: Paco Mechou (2063 in chips) 
Seat 8: rtrombin22 (2436 in chips) 
Seat 9: berilo.rama (1364 in chips) is sitting out
intelllect: posts the ante 10
ramigrilo: posts the ante 10
flagao: posts the ante 10
biroxadrez: posts the ante 10
thiagoflauzi: posts the ante 10
Paco Mechou: posts the ante 10
rtrombin22: posts the ante 10
berilo.rama: posts the ante 10
intelllect: posts small blind 40
ramigrilo: posts big blind 80
*** HOLE CARDS ***
Dealt to flagao [Kc Tc]
flagao: raises 80 to 160
biroxadrez: folds 
thiagoflauzi: folds 
Paco Mechou: calls 160
rtrombin22: calls 160
berilo.rama: folds 
intelllect: raises 1092 to 1252 and is all-in
ramigrilo: folds 
flagao: folds 
Paco Mechou: raises 801 to 2053 and is all-in
rtrombin22: calls 1893
*** FLOP *** [3h Jd 6d]
*** TURN *** [3h Jd 6d] [5s]
*** RIVER *** [3h Jd 6d 5s] [Kd]
*** SHOW DOWN ***
Paco Mechou: shows [As 9c] (high card Ace)
rtrombin22: shows [Qs Ad] (high card Ace - King+Queen kicker)
rtrombin22 collected 1602 from side pot
intelllect: shows [7c 7s] (a pair of Sevens)
intelllect collected 4076 from main pot
Paco Mechou finished the tournament in 33rd place
*** SUMMARY ***
Total pot 5678 Main pot 4076. Side pot 1602. | Rake 0 
Board [3h Jd 6d 5s Kd]
Seat 1: intelllect (small blind) showed [7c 7s] and won (4076) with a pair of Sevens
Seat 2: ramigrilo (big blind) folded before Flop
Seat 3: flagao folded before Flop
Seat 5: biroxadrez folded before Flop (didn't bet)
Seat 6: thiagoflauzi folded before Flop (didn't bet)
Seat 7: Paco Mechou showed [As 9c] and lost with high card Ace
Seat 8: rtrombin22 showed [Qs Ad] and won (1602) with high card Ace
Seat 9: berilo.rama (button) folded before Flop (didn't bet)



PokerStars Hand #189311705626: Tournament #2369778109, $0.23+$0.02 USD Hold'em No Limit - Level IV (40/80) - 2018/07/29 20:43:41 ET
Table '2369778109 1' 9-max Seat #1 is the button
Seat 1: intelllect (4076 in chips) 
Seat 2: ramigrilo (3055 in chips) 
Seat 3: flagao (3010 in chips) 
Seat 5: biroxadrez (658 in chips) 
Seat 6: thiagoflauzi (645 in chips) 
Seat 8: rtrombin22 (1975 in chips) 
Seat 9: berilo.rama (1354 in chips) is sitting out
intelllect: posts the ante 10
ramigrilo: posts the ante 10
flagao: posts the ante 10
biroxadrez: posts the ante 10
thiagoflauzi: posts the ante 10
rtrombin22: posts the ante 10
berilo.rama: posts the ante 10
ramigrilo: posts small blind 40
flagao: posts big blind 80
*** HOLE CARDS ***
Dealt to flagao [6c 5h]
biroxadrez: calls 80
thiagoflauzi: folds 
rtrombin22: calls 80
berilo.rama: folds 
intelllect: folds 
ramigrilo: folds 
flagao: checks 
*** FLOP *** [5d 8s 5c]
flagao: checks 
biroxadrez: bets 568 and is all-in
rtrombin22: calls 568
flagao: raises 872 to 1440
rtrombin22: folds 
Uncalled bet (872) returned to flagao
*** TURN *** [5d 8s 5c] [Ac]
*** RIVER *** [5d 8s 5c Ac] [4h]
*** SHOW DOWN ***
flagao: shows [6c 5h] (three of a kind, Fives)
biroxadrez: shows [Kd Qs] (a pair of Fives)
flagao collected 2054 from pot
biroxadrez finished the tournament in 31st place
*** SUMMARY ***
Total pot 2054 | Rake 0 
Board [5d 8s 5c Ac 4h]
Seat 1: intelllect (button) folded before Flop (didn't bet)
Seat 2: ramigrilo (small blind) folded before Flop
Seat 3: flagao (big blind) showed [6c 5h] and won (2054) with three of a kind, Fives
Seat 5: biroxadrez showed [Kd Qs] and lost with a pair of Fives
Seat 6: thiagoflauzi folded before Flop (didn't bet)
Seat 8: rtrombin22 folded on the Flop
Seat 9: berilo.rama folded before Flop (didn't bet)



PokerStars Hand #189311725191: Tournament #2369778109, $0.23+$0.02 USD Hold'em No Limit - Level IV (40/80) - 2018/07/29 20:44:31 ET
Table '2369778109 1' 9-max Seat #2 is the button
Seat 1: intelllect (4066 in chips) 
Seat 2: ramigrilo (3005 in chips) 
Seat 3: flagao (4406 in chips) 
Seat 6: thiagoflauzi (635 in chips) 
Seat 8: rtrombin22 (1317 in chips) 
Seat 9: berilo.rama (1344 in chips) is sitting out
intelllect: posts the ante 10
ramigrilo: posts the ante 10
flagao: posts the ante 10
thiagoflauzi: posts the ante 10
rtrombin22: posts the ante 10
berilo.rama: posts the ante 10
flagao: posts small blind 40
thiagoflauzi: posts big blind 80
*** HOLE CARDS ***
Dealt to flagao [9s 2c]
rtrombin22: folds 
berilo.rama: folds 
intelllect: folds 
ramigrilo: folds 
flagao: folds 
Uncalled bet (40) returned to thiagoflauzi
thiagoflauzi collected 140 from pot
thiagoflauzi: doesn't show hand 
*** SUMMARY ***
Total pot 140 | Rake 0 
Seat 1: intelllect folded before Flop (didn't bet)
Seat 2: ramigrilo (button) folded before Flop (didn't bet)
Seat 3: flagao (small blind) folded before Flop
Seat 6: thiagoflauzi (big blind) collected (140)
Seat 8: rtrombin22 folded before Flop (didn't bet)
Seat 9: berilo.rama folded before Flop (didn't bet)



PokerStars Hand #189311735614: Tournament #2369778109, $0.23+$0.02 USD Hold'em No Limit - Level IV (40/80) - 2018/07/29 20:44:57 ET
Table '2369778109 1' 9-max Seat #3 is the button
Seat 1: intelllect (4056 in chips) 
Seat 2: ramigrilo (2995 in chips) 
Seat 3: flagao (4356 in chips) 
Seat 6: thiagoflauzi (725 in chips) 
Seat 8: rtrombin22 (1307 in chips) 
Seat 9: berilo.rama (1334 in chips) is sitting out
intelllect: posts the ante 10
ramigrilo: posts the ante 10
flagao: posts the ante 10
thiagoflauzi: posts the ante 10
rtrombin22: posts the ante 10
berilo.rama: posts the ante 10
thiagoflauzi: posts small blind 40
rtrombin22: posts big blind 80
*** HOLE CARDS ***
Dealt to flagao [8h Th]
berilo.rama: folds 
intelllect: folds 
ramigrilo: raises 160 to 240
flagao: folds 
thiagoflauzi: folds 
rtrombin22: folds 
Uncalled bet (160) returned to ramigrilo
ramigrilo collected 260 from pot
ramigrilo: doesn't show hand 
*** SUMMARY ***
Total pot 260 | Rake 0 
Seat 1: intelllect folded before Flop (didn't bet)
Seat 2: ramigrilo collected (260)
Seat 3: flagao (button) folded before Flop (didn't bet)
Seat 6: thiagoflauzi (small blind) folded before Flop
Seat 8: rtrombin22 (big blind) folded before Flop
Seat 9: berilo.rama folded before Flop (didn't bet)



PokerStars Hand #189311743807: Tournament #2369778109, $0.23+$0.02 USD Hold'em No Limit - Level IV (40/80) - 2018/07/29 20:45:17 ET
Table '2369778109 1' 9-max Seat #6 is the button
Seat 1: intelllect (4046 in chips) 
Seat 2: ramigrilo (3165 in chips) 
Seat 3: flagao (4346 in chips) 
Seat 4: Axxxidental (3048 in chips) 
Seat 6: thiagoflauzi (675 in chips) 
Seat 8: rtrombin22 (1217 in chips) 
Seat 9: berilo.rama (1324 in chips) is sitting out
intelllect: posts the ante 10
ramigrilo: posts the ante 10
flagao: posts the ante 10
Axxxidental: posts the ante 10
thiagoflauzi: posts the ante 10
rtrombin22: posts the ante 10
berilo.rama: posts the ante 10
rtrombin22: posts small blind 40
berilo.rama: posts big blind 80
*** HOLE CARDS ***
Dealt to flagao [3d Ks]
intelllect: folds 
ramigrilo: folds 
flagao: folds 
Axxxidental: folds 
thiagoflauzi: raises 585 to 665 and is all-in
rtrombin22: raises 542 to 1207 and is all-in
berilo.rama: folds 
Uncalled bet (542) returned to rtrombin22
*** FLOP *** [Td 9h 2c]
*** TURN *** [Td 9h 2c] [Kh]
*** RIVER *** [Td 9h 2c Kh] [Jd]
*** SHOW DOWN ***
rtrombin22: shows [2d Qd] (a straight, Nine to King)
thiagoflauzi: shows [As 4s] (high card Ace)
rtrombin22 collected 1480 from pot
thiagoflauzi finished the tournament in 29th place
*** SUMMARY ***
Total pot 1480 | Rake 0 
Board [Td 9h 2c Kh Jd]
Seat 1: intelllect folded before Flop (didn't bet)
Seat 2: ramigrilo folded before Flop (didn't bet)
Seat 3: flagao folded before Flop (didn't bet)
Seat 4: Axxxidental folded before Flop (didn't bet)
Seat 6: thiagoflauzi (button) showed [As 4s] and lost with high card Ace
Seat 8: rtrombin22 (small blind) showed [2d Qd] and won (1480) with a straight, Nine to King
Seat 9: berilo.rama (big blind) folded before Flop



PokerStars Hand #189311756485: Tournament #2369778109, $0.23+$0.02 USD Hold'em No Limit - Level IV (40/80) - 2018/07/29 20:45:49 ET
Table '2369778109 1' 9-max Seat #8 is the button
Seat 1: intelllect (4036 in chips) 
Seat 2: ramigrilo (3155 in chips) 
Seat 3: flagao (4336 in chips) 
Seat 4: Axxxidental (3038 in chips) 
Seat 8: rtrombin22 (2022 in chips) 
Seat 9: berilo.rama (1234 in chips) is sitting out
intelllect: posts the ante 10
ramigrilo: posts the ante 10
flagao: posts the ante 10
Axxxidental: posts the ante 10
rtrombin22: posts the ante 10
berilo.rama: posts the ante 10
berilo.rama: posts small blind 40
intelllect: posts big blind 80
*** HOLE CARDS ***
Dealt to flagao [4s Th]
ramigrilo: folds 
flagao: folds 
Axxxidental: folds 
rtrombin22: raises 1932 to 2012 and is all-in
berilo.rama: folds 
intelllect: folds 
Uncalled bet (1932) returned to rtrombin22
rtrombin22 collected 260 from pot
rtrombin22: doesn't show hand 
*** SUMMARY ***
Total pot 260 | Rake 0 
Seat 1: intelllect (big blind) folded before Flop
Seat 2: ramigrilo folded before Flop (didn't bet)
Seat 3: flagao folded before Flop (didn't bet)
Seat 4: Axxxidental folded before Flop (didn't bet)
Seat 8: rtrombin22 (button) collected (260)
Seat 9: berilo.rama (small blind) folded before Flop



PokerStars Hand #189311766581: Tournament #2369778109, $0.23+$0.02 USD Hold'em No Limit - Level IV (40/80) - 2018/07/29 20:46:15 ET
Table '2369778109 1' 9-max Seat #9 is the button
Seat 1: intelllect (3946 in chips) 
Seat 2: ramigrilo (3145 in chips) 
Seat 3: flagao (4326 in chips) 
Seat 4: Axxxidental (3028 in chips) 
Seat 5: RodrigoCrvll (1419 in chips) 
Seat 8: rtrombin22 (2192 in chips) 
Seat 9: berilo.rama (1184 in chips) is sitting out
intelllect: posts the ante 10
ramigrilo: posts the ante 10
flagao: posts the ante 10
Axxxidental: posts the ante 10
RodrigoCrvll: posts the ante 10
rtrombin22: posts the ante 10
berilo.rama: posts the ante 10
intelllect: posts small blind 40
ramigrilo: posts big blind 80
*** HOLE CARDS ***
Dealt to flagao [6s 3s]
flagao: folds 
Axxxidental: raises 96 to 176
RodrigoCrvll: folds 
rtrombin22: folds 
berilo.rama: folds 
intelllect: calls 136
ramigrilo: folds 
*** FLOP *** [4d 5d Kc]
intelllect: checks 
Axxxidental: bets 166
intelllect: folds 
Uncalled bet (166) returned to Axxxidental
Axxxidental collected 502 from pot
*** SUMMARY ***
Total pot 502 | Rake 0 
Board [4d 5d Kc]
Seat 1: intelllect (small blind) folded on the Flop
Seat 2: ramigrilo (big blind) folded before Flop
Seat 3: flagao folded before Flop (didn't bet)
Seat 4: Axxxidental collected (502)
Seat 5: RodrigoCrvll folded before Flop (didn't bet)
Seat 8: rtrombin22 folded before Flop (didn't bet)
Seat 9: berilo.rama (button) folded before Flop (didn't bet)



PokerStars Hand #189311787494: Tournament #2369778109, $0.23+$0.02 USD Hold'em No Limit - Level IV (40/80) - 2018/07/29 20:47:08 ET
Table '2369778109 1' 9-max Seat #1 is the button
Seat 1: intelllect (3760 in chips) 
Seat 2: ramigrilo (3055 in chips) 
Seat 3: flagao (4316 in chips) 
Seat 4: Axxxidental (3344 in chips) 
Seat 5: RodrigoCrvll (1409 in chips) 
Seat 6: RedWhite86 (3577 in chips) 
Seat 7: Gremista123™ (856 in chips) is sitting out
Seat 8: rtrombin22 (2182 in chips) 
Seat 9: berilo.rama (1174 in chips) is sitting out
intelllect: posts the ante 10
ramigrilo: posts the ante 10
flagao: posts the ante 10
Axxxidental: posts the ante 10
RodrigoCrvll: posts the ante 10
RedWhite86: posts the ante 10
Gremista123™: posts the ante 10
rtrombin22: posts the ante 10
berilo.rama: posts the ante 10
ramigrilo: posts small blind 40
flagao: posts big blind 80
*** HOLE CARDS ***
Dealt to flagao [Td Ac]
Axxxidental: folds 
RodrigoCrvll: folds 
RedWhite86: folds 
Gremista123™: folds 
rtrombin22: folds 
berilo.rama: folds 
intelllect: folds 
ramigrilo has timed out
ramigrilo: folds 
ramigrilo is sitting out
Uncalled bet (40) returned to flagao
flagao collected 170 from pot
flagao: doesn't show hand 
*** SUMMARY ***
Total pot 170 | Rake 0 
Seat 1: intelllect (button) folded before Flop (didn't bet)
Seat 2: ramigrilo (small blind) folded before Flop
Seat 3: flagao (big blind) collected (170)
Seat 4: Axxxidental folded before Flop (didn't bet)
Seat 5: RodrigoCrvll folded before Flop (didn't bet)
Seat 6: RedWhite86 folded before Flop (didn't bet)
Seat 7: Gremista123™ folded before Flop (didn't bet)
Seat 8: rtrombin22 folded before Flop (didn't bet)
Seat 9: berilo.rama folded before Flop (didn't bet)



PokerStars Hand #189311825249: Tournament #2369778109, $0.23+$0.02 USD Hold'em No Limit - Level IV (40/80) - 2018/07/29 20:48:44 ET
Table '2369778109 1' 9-max Seat #2 is the button
Seat 1: intelllect (3750 in chips) 
Seat 2: ramigrilo (3005 in chips) is sitting out
Seat 3: flagao (4436 in chips) 
Seat 4: Axxxidental (3334 in chips) 
Seat 5: RodrigoCrvll (1399 in chips) 
Seat 6: RedWhite86 (3567 in chips) 
Seat 7: Gremista123™ (846 in chips) is sitting out
Seat 8: rtrombin22 (2172 in chips) 
Seat 9: berilo.rama (1164 in chips) is sitting out
intelllect: posts the ante 10
ramigrilo: posts the ante 10
flagao: posts the ante 10
Axxxidental: posts the ante 10
RodrigoCrvll: posts the ante 10
RedWhite86: posts the ante 10
Gremista123™: posts the ante 10
rtrombin22: posts the ante 10
berilo.rama: posts the ante 10
flagao: posts small blind 40
Axxxidental: posts big blind 80
*** HOLE CARDS ***
Dealt to flagao [Jh Td]
RodrigoCrvll: folds 
RedWhite86: folds 
Gremista123™: folds 
rtrombin22: folds 
berilo.rama: folds 
intelllect: raises 80 to 160
ramigrilo: folds 
flagao: folds 
Axxxidental: raises 383 to 543
intelllect: raises 897 to 1440
Axxxidental: folds 
Uncalled bet (897) returned to intelllect
intelllect collected 1216 from pot
intelllect: doesn't show hand 
*** SUMMARY ***
Total pot 1216 | Rake 0 
Seat 1: intelllect collected (1216)
Seat 2: ramigrilo (button) folded before Flop (didn't bet)
Seat 3: flagao (small blind) folded before Flop
Seat 4: Axxxidental (big blind) folded before Flop
Seat 5: RodrigoCrvll folded before Flop (didn't bet)
Seat 6: RedWhite86 folded before Flop (didn't bet)
Seat 7: Gremista123™ folded before Flop (didn't bet)
Seat 8: rtrombin22 folded before Flop (didn't bet)
Seat 9: berilo.rama folded before Flop (didn't bet)



PokerStars Hand #189311845962: Tournament #2369778109, $0.23+$0.02 USD Hold'em No Limit - Level IV (40/80) - 2018/07/29 20:49:37 ET
Table '2369778109 1' 9-max Seat #3 is the button
Seat 1: intelllect (4413 in chips) 
Seat 2: ramigrilo (2995 in chips) is sitting out
Seat 3: flagao (4386 in chips) 
Seat 4: Axxxidental (2781 in chips) 
Seat 5: RodrigoCrvll (1389 in chips) 
Seat 6: RedWhite86 (3557 in chips) 
Seat 7: Gremista123™ (836 in chips) is sitting out
Seat 8: rtrombin22 (2162 in chips) 
Seat 9: berilo.rama (1154 in chips) is sitting out
intelllect: posts the ante 10
ramigrilo: posts the ante 10
flagao: posts the ante 10
Axxxidental: posts the ante 10
RodrigoCrvll: posts the ante 10
RedWhite86: posts the ante 10
Gremista123™: posts the ante 10
rtrombin22: posts the ante 10
berilo.rama: posts the ante 10
Axxxidental: posts small blind 40
RodrigoCrvll: posts big blind 80
*** HOLE CARDS ***
Dealt to flagao [4c 8c]
RedWhite86: folds 
Gremista123™: folds 
rtrombin22: folds 
berilo.rama: folds 
intelllect: folds 
ramigrilo: folds 
flagao: folds 
Axxxidental: folds 
Uncalled bet (40) returned to RodrigoCrvll
RodrigoCrvll collected 170 from pot
RodrigoCrvll: doesn't show hand 
*** SUMMARY ***
Total pot 170 | Rake 0 
Seat 1: intelllect folded before Flop (didn't bet)
Seat 2: ramigrilo folded before Flop (didn't bet)
Seat 3: flagao (button) folded before Flop (didn't bet)
Seat 4: Axxxidental (small blind) folded before Flop
Seat 5: RodrigoCrvll (big blind) collected (170)
Seat 6: RedWhite86 folded before Flop (didn't bet)
Seat 7: Gremista123™ folded before Flop (didn't bet)
Seat 8: rtrombin22 folded before Flop (didn't bet)
Seat 9: berilo.rama folded before Flop (didn't bet)



PokerStars Hand #189311850406: Tournament #2369778109, $0.23+$0.02 USD Hold'em No Limit - Level IV (40/80) - 2018/07/29 20:49:49 ET
Table '2369778109 1' 9-max Seat #4 is the button
Seat 1: intelllect (4403 in chips) 
Seat 2: ramigrilo (2985 in chips) is sitting out
Seat 3: flagao (4376 in chips) 
Seat 4: Axxxidental (2731 in chips) 
Seat 5: RodrigoCrvll (1509 in chips) 
Seat 6: RedWhite86 (3547 in chips) 
Seat 7: Gremista123™ (826 in chips) is sitting out
Seat 8: rtrombin22 (2152 in chips) 
Seat 9: berilo.rama (1144 in chips) is sitting out
intelllect: posts the ante 10
ramigrilo: posts the ante 10
flagao: posts the ante 10
Axxxidental: posts the ante 10
RodrigoCrvll: posts the ante 10
RedWhite86: posts the ante 10
Gremista123™: posts the ante 10
rtrombin22: posts the ante 10
berilo.rama: posts the ante 10
RodrigoCrvll: posts small blind 40
RedWhite86: posts big blind 80
*** HOLE CARDS ***
Dealt to flagao [7c 6c]
Gremista123™: folds 
ramigrilo has returned
rtrombin22: folds 
berilo.rama: folds 
intelllect: folds 
ramigrilo: folds 
flagao: raises 80 to 160
Axxxidental: folds 
RodrigoCrvll: folds 
RedWhite86: folds 
Uncalled bet (80) returned to flagao
flagao collected 290 from pot
flagao: doesn't show hand 
*** SUMMARY ***
Total pot 290 | Rake 0 
Seat 1: intelllect folded before Flop (didn't bet)
Seat 2: ramigrilo folded before Flop (didn't bet)
Seat 3: flagao collected (290)
Seat 4: Axxxidental (button) folded before Flop (didn't bet)
Seat 5: RodrigoCrvll (small blind) folded before Flop
Seat 6: RedWhite86 (big blind) folded before Flop
Seat 7: Gremista123™ folded before Flop (didn't bet)
Seat 8: rtrombin22 folded before Flop (didn't bet)
Seat 9: berilo.rama folded before Flop (didn't bet)



PokerStars Hand #189311866814: Tournament #2369778109, $0.23+$0.02 USD Hold'em No Limit - Level IV (40/80) - 2018/07/29 20:50:31 ET
Table '2369778109 1' 9-max Seat #5 is the button
Seat 1: intelllect (4393 in chips) 
Seat 2: ramigrilo (2975 in chips) 
Seat 3: flagao (4576 in chips) 
Seat 4: Axxxidental (2721 in chips) 
Seat 5: RodrigoCrvll (1459 in chips) 
Seat 6: RedWhite86 (3457 in chips) 
Seat 7: Gremista123™ (816 in chips) is sitting out
Seat 8: rtrombin22 (2142 in chips) 
Seat 9: berilo.rama (1134 in chips) is sitting out
intelllect: posts the ante 10
ramigrilo: posts the ante 10
flagao: posts the ante 10
Axxxidental: posts the ante 10
RodrigoCrvll: posts the ante 10
RedWhite86: posts the ante 10
Gremista123™: posts the ante 10
rtrombin22: posts the ante 10
berilo.rama: posts the ante 10
RedWhite86: posts small blind 40
Gremista123™: posts big blind 80
*** HOLE CARDS ***
Dealt to flagao [Qd 4d]
rtrombin22: folds 
berilo.rama: folds 
intelllect: folds 
ramigrilo: raises 80 to 160
flagao: folds 
Axxxidental: folds 
RodrigoCrvll: folds 
RedWhite86: raises 320 to 480
Gremista123™: folds 
ramigrilo: calls 320
*** FLOP *** [8s 4c 7d]
RedWhite86: bets 480
ramigrilo: folds 
Uncalled bet (480) returned to RedWhite86
RedWhite86 collected 1130 from pot
RedWhite86: doesn't show hand 
*** SUMMARY ***
Total pot 1130 | Rake 0 
Board [8s 4c 7d]
Seat 1: intelllect folded before Flop (didn't bet)
Seat 2: ramigrilo folded on the Flop
Seat 3: flagao folded before Flop (didn't bet)
Seat 4: Axxxidental folded before Flop (didn't bet)
Seat 5: RodrigoCrvll (button) folded before Flop (didn't bet)
Seat 6: RedWhite86 (small blind) collected (1130)
Seat 7: Gremista123™ (big blind) folded before Flop
Seat 8: rtrombin22 folded before Flop (didn't bet)
Seat 9: berilo.rama folded before Flop (didn't bet)



PokerStars Hand #189311883456: Tournament #2369778109, $0.23+$0.02 USD Hold'em No Limit - Level IV (40/80) - 2018/07/29 20:51:14 ET
Table '2369778109 1' 9-max Seat #6 is the button
Seat 1: intelllect (4383 in chips) 
Seat 2: ramigrilo (2485 in chips) 
Seat 3: flagao (4566 in chips) 
Seat 4: Axxxidental (2711 in chips) 
Seat 5: RodrigoCrvll (1449 in chips) 
Seat 6: RedWhite86 (4097 in chips) 
Seat 7: Gremista123™ (726 in chips) is sitting out
Seat 8: rtrombin22 (2132 in chips) 
Seat 9: berilo.rama (1124 in chips) is sitting out
intelllect: posts the ante 10
ramigrilo: posts the ante 10
flagao: posts the ante 10
Axxxidental: posts the ante 10
RodrigoCrvll: posts the ante 10
RedWhite86: posts the ante 10
Gremista123™: posts the ante 10
rtrombin22: posts the ante 10
berilo.rama: posts the ante 10
Gremista123™: posts small blind 40
rtrombin22: posts big blind 80
*** HOLE CARDS ***
Dealt to flagao [7h As]
berilo.rama: folds 
intelllect: folds 
ramigrilo: folds 
flagao: raises 80 to 160
Axxxidental: folds 
RodrigoCrvll: folds 
RedWhite86: folds 
Gremista123™: folds 
rtrombin22: folds 
Uncalled bet (80) returned to flagao
flagao collected 290 from pot
flagao: doesn't show hand 
*** SUMMARY ***
Total pot 290 | Rake 0 
Seat 1: intelllect folded before Flop (didn't bet)
Seat 2: ramigrilo folded before Flop (didn't bet)
Seat 3: flagao collected (290)
Seat 4: Axxxidental folded before Flop (didn't bet)
Seat 5: RodrigoCrvll folded before Flop (didn't bet)
Seat 6: RedWhite86 (button) folded before Flop (didn't bet)
Seat 7: Gremista123™ (small blind) folded before Flop
Seat 8: rtrombin22 (big blind) folded before Flop
Seat 9: berilo.rama folded before Flop (didn't bet)



PokerStars Hand #189311896364: Tournament #2369778109, $0.23+$0.02 USD Hold'em No Limit - Level V (60/120) - 2018/07/29 20:51:47 ET
Table '2369778109 1' 9-max Seat #7 is the button
Seat 1: intelllect (4373 in chips) 
Seat 3: flagao (4766 in chips) 
Seat 4: Axxxidental (2701 in chips) 
Seat 5: RodrigoCrvll (1439 in chips) 
Seat 6: RedWhite86 (4087 in chips) 
Seat 7: Gremista123™ (676 in chips) is sitting out
Seat 8: rtrombin22 (2042 in chips) 
Seat 9: berilo.rama (1114 in chips) is sitting out
intelllect: posts the ante 15
flagao: posts the ante 15
Axxxidental: posts the ante 15
RodrigoCrvll: posts the ante 15
RedWhite86: posts the ante 15
Gremista123™: posts the ante 15
rtrombin22: posts the ante 15
berilo.rama: posts the ante 15
rtrombin22: posts small blind 60
berilo.rama: posts big blind 120
*** HOLE CARDS ***
Dealt to flagao [Kc 7h]
intelllect: folds 
flagao: folds 
Axxxidental: folds 
RodrigoCrvll: folds 
RedWhite86: raises 3952 to 4072 and is all-in
Gremista123™: folds 
rtrombin22: calls 1967 and is all-in
berilo.rama: folds 
Uncalled bet (2045) returned to RedWhite86
*** FLOP *** [5d 6s 2c]
*** TURN *** [5d 6s 2c] [6c]
*** RIVER *** [5d 6s 2c 6c] [5c]
*** SHOW DOWN ***
rtrombin22: shows [9s As] (two pair, Sixes and Fives)
RedWhite86: shows [8h Qd] (two pair, Sixes and Fives - lower kicker)
rtrombin22 collected 4294 from pot
*** SUMMARY ***
Total pot 4294 | Rake 0 
Board [5d 6s 2c 6c 5c]
Seat 1: intelllect folded before Flop (didn't bet)
Seat 3: flagao folded before Flop (didn't bet)
Seat 4: Axxxidental folded before Flop (didn't bet)
Seat 5: RodrigoCrvll folded before Flop (didn't bet)
Seat 6: RedWhite86 showed [8h Qd] and lost with two pair, Sixes and Fives
Seat 7: Gremista123™ (button) folded before Flop (didn't bet)
Seat 8: rtrombin22 (small blind) showed [9s As] and won (4294) with two pair, Sixes and Fives
Seat 9: berilo.rama (big blind) folded before Flop



PokerStars Hand #189311912616: Tournament #2369778109, $0.23+$0.02 USD Hold'em No Limit - Level V (60/120) - 2018/07/29 20:52:29 ET
Table '2369778109 1' 9-max Seat #8 is the button
Seat 1: intelllect (4358 in chips) 
Seat 3: flagao (4751 in chips) 
Seat 4: Axxxidental (2686 in chips) 
Seat 5: RodrigoCrvll (1424 in chips) 
Seat 6: RedWhite86 (2045 in chips) 
Seat 7: Gremista123™ (661 in chips) is sitting out
Seat 8: rtrombin22 (4294 in chips) 
Seat 9: berilo.rama (979 in chips) is sitting out
intelllect: posts the ante 15
flagao: posts the ante 15
Axxxidental: posts the ante 15
RodrigoCrvll: posts the ante 15
RedWhite86: posts the ante 15
Gremista123™: posts the ante 15
rtrombin22: posts the ante 15
berilo.rama: posts the ante 15
berilo.rama: posts small blind 60
intelllect: posts big blind 120
*** HOLE CARDS ***
Dealt to flagao [Jh Ah]
flagao: raises 120 to 240
Axxxidental: folds 
RodrigoCrvll: folds 
RedWhite86: raises 1790 to 2030 and is all-in
Gremista123™: folds 
rtrombin22: folds 
berilo.rama: folds 
intelllect: folds 
flagao: folds 
Uncalled bet (1790) returned to RedWhite86
RedWhite86 collected 780 from pot
RedWhite86: doesn't show hand 
*** SUMMARY ***
Total pot 780 | Rake 0 
Seat 1: intelllect (big blind) folded before Flop
Seat 3: flagao folded before Flop
Seat 4: Axxxidental folded before Flop (didn't bet)
Seat 5: RodrigoCrvll folded before Flop (didn't bet)
Seat 6: RedWhite86 collected (780)
Seat 7: Gremista123™ folded before Flop (didn't bet)
Seat 8: rtrombin22 (button) folded before Flop (didn't bet)
Seat 9: berilo.rama (small blind) folded before Flop



PokerStars Hand #189311925403: Tournament #2369778109, $0.23+$0.02 USD Hold'em No Limit - Level V (60/120) - 2018/07/29 20:53:02 ET
Table '2369778109 1' 9-max Seat #9 is the button
Seat 1: intelllect (4223 in chips) 
Seat 3: flagao (4496 in chips) 
Seat 4: Axxxidental (2671 in chips) 
Seat 5: RodrigoCrvll (1409 in chips) 
Seat 6: RedWhite86 (2570 in chips) 
Seat 7: Gremista123™ (646 in chips) is sitting out
Seat 8: rtrombin22 (4279 in chips) 
Seat 9: berilo.rama (904 in chips) is sitting out
intelllect: posts the ante 15
flagao: posts the ante 15
Axxxidental: posts the ante 15
RodrigoCrvll: posts the ante 15
RedWhite86: posts the ante 15
Gremista123™: posts the ante 15
rtrombin22: posts the ante 15
berilo.rama: posts the ante 15
intelllect: posts small blind 60
flagao: posts big blind 120
*** HOLE CARDS ***
Dealt to flagao [4c 6d]
Axxxidental: folds 
RodrigoCrvll: folds 
RedWhite86: folds 
Gremista123™: folds 
rtrombin22: folds 
berilo.rama: folds 
intelllect: calls 60
flagao: checks 
*** FLOP *** [7d 7h Ac]
intelllect: checks 
flagao: bets 240
intelllect: folds 
Uncalled bet (240) returned to flagao
flagao collected 360 from pot
flagao: doesn't show hand 
*** SUMMARY ***
Total pot 360 | Rake 0 
Board [7d 7h Ac]
Seat 1: intelllect (small blind) folded on the Flop
Seat 3: flagao (big blind) collected (360)
Seat 4: Axxxidental folded before Flop (didn't bet)
Seat 5: RodrigoCrvll folded before Flop (didn't bet)
Seat 6: RedWhite86 folded before Flop (didn't bet)
Seat 7: Gremista123™ folded before Flop (didn't bet)
Seat 8: rtrombin22 folded before Flop (didn't bet)
Seat 9: berilo.rama (button) folded before Flop (didn't bet)



PokerStars Hand #189311944504: Tournament #2369778109, $0.23+$0.02 USD Hold'em No Limit - Level V (60/120) - 2018/07/29 20:53:52 ET
Table '2369778109 1' 9-max Seat #1 is the button
Seat 1: intelllect (4088 in chips) 
Seat 3: flagao (4721 in chips) 
Seat 4: Axxxidental (2656 in chips) 
Seat 5: RodrigoCrvll (1394 in chips) 
Seat 6: RedWhite86 (2555 in chips) 
Seat 7: Gremista123™ (631 in chips) is sitting out
Seat 8: rtrombin22 (4264 in chips) 
Seat 9: berilo.rama (889 in chips) is sitting out
intelllect: posts the ante 15
flagao: posts the ante 15
Axxxidental: posts the ante 15
RodrigoCrvll: posts the ante 15
RedWhite86: posts the ante 15
Gremista123™: posts the ante 15
rtrombin22: posts the ante 15
berilo.rama: posts the ante 15
flagao: posts small blind 60
Axxxidental: posts big blind 120
*** HOLE CARDS ***
Dealt to flagao [6d 8c]
RodrigoCrvll: folds 
RedWhite86: folds 
Gremista123™: folds 
rtrombin22 is disconnected 
rtrombin22 is connected 
rtrombin22: folds 
berilo.rama: folds 
intelllect: raises 120 to 240
flagao: folds 
Axxxidental: folds 
Uncalled bet (120) returned to intelllect
intelllect collected 420 from pot
intelllect: doesn't show hand 
*** SUMMARY ***
Total pot 420 | Rake 0 
Seat 1: intelllect (button) collected (420)
Seat 3: flagao (small blind) folded before Flop
Seat 4: Axxxidental (big blind) folded before Flop
Seat 5: RodrigoCrvll folded before Flop (didn't bet)
Seat 6: RedWhite86 folded before Flop (didn't bet)
Seat 7: Gremista123™ folded before Flop (didn't bet)
Seat 8: rtrombin22 folded before Flop (didn't bet)
Seat 9: berilo.rama folded before Flop (didn't bet)



PokerStars Hand #189311965733: Tournament #2369778109, $0.23+$0.02 USD Hold'em No Limit - Level V (60/120) - 2018/07/29 20:54:47 ET
Table '2369778109 1' 9-max Seat #3 is the button
Seat 1: intelllect (4373 in chips) 
Seat 3: flagao (4646 in chips) 
Seat 4: Axxxidental (2521 in chips) 
Seat 5: RodrigoCrvll (1379 in chips) 
Seat 6: RedWhite86 (2540 in chips) 
Seat 7: Gremista123™ (616 in chips) is sitting out
Seat 8: rtrombin22 (4249 in chips) 
Seat 9: berilo.rama (874 in chips) is sitting out
intelllect: posts the ante 15
flagao: posts the ante 15
Axxxidental: posts the ante 15
RodrigoCrvll: posts the ante 15
RedWhite86: posts the ante 15
Gremista123™: posts the ante 15
rtrombin22: posts the ante 15
berilo.rama: posts the ante 15
Axxxidental: posts small blind 60
RodrigoCrvll: posts big blind 120
*** HOLE CARDS ***
Dealt to flagao [Ks 6d]
RedWhite86: folds 
Gremista123™: folds 
rtrombin22: raises 144 to 264
berilo.rama: folds 
intelllect: folds 
flagao: folds 
Axxxidental: folds 
RodrigoCrvll: calls 144
*** FLOP *** [Kd 8s 3d]
RodrigoCrvll: checks 
rtrombin22: checks 
*** TURN *** [Kd 8s 3d] [Qd]
RodrigoCrvll: bets 240
rtrombin22: calls 240
*** RIVER *** [Kd 8s 3d Qd] [As]
RodrigoCrvll: bets 360
rtrombin22: calls 360
*** SHOW DOWN ***
RodrigoCrvll: shows [Qh Kc] (two pair, Kings and Queens)
rtrombin22: mucks hand 
RodrigoCrvll collected 1908 from pot
*** SUMMARY ***
Total pot 1908 | Rake 0 
Board [Kd 8s 3d Qd As]
Seat 1: intelllect folded before Flop (didn't bet)
Seat 3: flagao (button) folded before Flop (didn't bet)
Seat 4: Axxxidental (small blind) folded before Flop
Seat 5: RodrigoCrvll (big blind) showed [Qh Kc] and won (1908) with two pair, Kings and Queens
Seat 6: RedWhite86 folded before Flop (didn't bet)
Seat 7: Gremista123™ folded before Flop (didn't bet)
Seat 8: rtrombin22 mucked [Ad Jc]
Seat 9: berilo.rama folded before Flop (didn't bet)



PokerStars Hand #189312083040: Tournament #2369778109, $0.23+$0.02 USD Hold'em No Limit - Level V (60/120) - 2018/07/29 21:00:58 ET
Table '2369778109 1' 9-max Seat #4 is the button
Seat 1: intelllect (4358 in chips) 
Seat 3: flagao (4631 in chips) 
Seat 4: Axxxidental (2446 in chips) 
Seat 5: RodrigoCrvll (2408 in chips) 
Seat 6: RedWhite86 (2525 in chips) 
Seat 7: Gremista123™ (601 in chips) is sitting out
Seat 8: rtrombin22 (3370 in chips) 
Seat 9: berilo.rama (859 in chips) is sitting out
intelllect: posts the ante 15
flagao: posts the ante 15
Axxxidental: posts the ante 15
RodrigoCrvll: posts the ante 15
RedWhite86: posts the ante 15
Gremista123™: posts the ante 15
rtrombin22: posts the ante 15
berilo.rama: posts the ante 15
RodrigoCrvll: posts small blind 60
RedWhite86: posts big blind 120
*** HOLE CARDS ***
Dealt to flagao [8s Qs]
Gremista123™: folds 
rtrombin22: folds 
berilo.rama: folds 
intelllect: folds 
flagao: folds 
Axxxidental: folds 
rtrombin22 is sitting out
RodrigoCrvll: calls 60
RedWhite86: checks 
*** FLOP *** [Ks 7s 2s]
RodrigoCrvll: checks 
RedWhite86: checks 
*** TURN *** [Ks 7s 2s] [6c]
RodrigoCrvll: checks 
RedWhite86: checks 
*** RIVER *** [Ks 7s 2s 6c] [5c]
RodrigoCrvll: checks 
RedWhite86: checks 
*** SHOW DOWN ***
RodrigoCrvll: shows [3d Ad] (high card Ace)
RedWhite86: mucks hand 
RodrigoCrvll collected 360 from pot
*** SUMMARY ***
Total pot 360 | Rake 0 
Board [Ks 7s 2s 6c 5c]
Seat 1: intelllect folded before Flop (didn't bet)
Seat 3: flagao folded before Flop (didn't bet)
Seat 4: Axxxidental (button) folded before Flop (didn't bet)
Seat 5: RodrigoCrvll (small blind) showed [3d Ad] and won (360) with high card Ace
Seat 6: RedWhite86 (big blind) mucked [3s Tc]
Seat 7: Gremista123™ folded before Flop (didn't bet)
Seat 8: rtrombin22 folded before Flop (didn't bet)
Seat 9: berilo.rama folded before Flop (didn't bet)



PokerStars Hand #189312111504: Tournament #2369778109, $0.23+$0.02 USD Hold'em No Limit - Level V (60/120) - 2018/07/29 21:02:17 ET
Table '2369778109 1' 9-max Seat #5 is the button
Seat 1: intelllect (4343 in chips) 
Seat 3: flagao (4616 in chips) 
Seat 4: Axxxidental (2431 in chips) 
Seat 5: RodrigoCrvll (2633 in chips) 
Seat 6: RedWhite86 (2390 in chips) 
Seat 7: Gremista123™ (586 in chips) is sitting out
Seat 8: rtrombin22 (3355 in chips) is sitting out
Seat 9: berilo.rama (844 in chips) is sitting out
intelllect: posts the ante 15
flagao: posts the ante 15
Axxxidental: posts the ante 15
RodrigoCrvll: posts the ante 15
RedWhite86: posts the ante 15
Gremista123™: posts the ante 15
rtrombin22: posts the ante 15
berilo.rama: posts the ante 15
RedWhite86: posts small blind 60
Gremista123™: posts big blind 120
*** HOLE CARDS ***
Dealt to flagao [Jd 9c]
rtrombin22: folds 
berilo.rama: folds 
intelllect: folds 
flagao: folds 
Axxxidental: folds 
RodrigoCrvll: folds 
RedWhite86: calls 60
Gremista123™: folds 
RedWhite86 collected 360 from pot
RedWhite86: doesn't show hand 
*** SUMMARY ***
Total pot 360 | Rake 0 
Seat 1: intelllect folded before Flop (didn't bet)
Seat 3: flagao folded before Flop (didn't bet)
Seat 4: Axxxidental folded before Flop (didn't bet)
Seat 5: RodrigoCrvll (button) folded before Flop (didn't bet)
Seat 6: RedWhite86 (small blind) collected (360)
Seat 7: Gremista123™ (big blind) folded before Flop
Seat 8: rtrombin22 folded before Flop (didn't bet)
Seat 9: berilo.rama folded before Flop (didn't bet)



PokerStars Hand #189312122769: Tournament #2369778109, $0.23+$0.02 USD Hold'em No Limit - Level V (60/120) - 2018/07/29 21:02:48 ET
Table '2369778109 1' 9-max Seat #6 is the button
Seat 1: intelllect (4328 in chips) 
Seat 3: flagao (4601 in chips) 
Seat 4: Axxxidental (2416 in chips) 
Seat 5: RodrigoCrvll (2618 in chips) 
Seat 6: RedWhite86 (2615 in chips) 
Seat 7: Gremista123™ (451 in chips) is sitting out
Seat 8: rtrombin22 (3340 in chips) is sitting out
Seat 9: berilo.rama (829 in chips) is sitting out
intelllect: posts the ante 15
flagao: posts the ante 15
Axxxidental: posts the ante 15
RodrigoCrvll: posts the ante 15
RedWhite86: posts the ante 15
Gremista123™: posts the ante 15
rtrombin22: posts the ante 15
berilo.rama: posts the ante 15
Gremista123™: posts small blind 60
rtrombin22: posts big blind 120
*** HOLE CARDS ***
Dealt to flagao [7h 4d]
berilo.rama: folds 
intelllect: folds 
flagao: folds 
Axxxidental: folds 
RodrigoCrvll: folds 
RedWhite86: calls 120
Gremista123™: folds 
rtrombin22: folds 
RedWhite86 collected 420 from pot
RedWhite86: doesn't show hand 
*** SUMMARY ***
Total pot 420 | Rake 0 
Seat 1: intelllect folded before Flop (didn't bet)
Seat 3: flagao folded before Flop (didn't bet)
Seat 4: Axxxidental folded before Flop (didn't bet)
Seat 5: RodrigoCrvll folded before Flop (didn't bet)
Seat 6: RedWhite86 (button) collected (420)
Seat 7: Gremista123™ (small blind) folded before Flop
Seat 8: rtrombin22 (big blind) folded before Flop
Seat 9: berilo.rama folded before Flop (didn't bet)



PokerStars Hand #189312130532: Tournament #2369778109, $0.23+$0.02 USD Hold'em No Limit - Level V (60/120) - 2018/07/29 21:03:08 ET
Table '2369778109 1' 9-max Seat #7 is the button
Seat 1: intelllect (4313 in chips) 
Seat 3: flagao (4586 in chips) 
Seat 4: Axxxidental (2401 in chips) 
Seat 5: RodrigoCrvll (2603 in chips) 
Seat 6: RedWhite86 (2900 in chips) 
Seat 7: Gremista123™ (376 in chips) is sitting out
Seat 8: rtrombin22 (3205 in chips) is sitting out
Seat 9: berilo.rama (814 in chips) is sitting out
intelllect: posts the ante 15
flagao: posts the ante 15
Axxxidental: posts the ante 15
RodrigoCrvll: posts the ante 15
RedWhite86: posts the ante 15
Gremista123™: posts the ante 15
rtrombin22: posts the ante 15
berilo.rama: posts the ante 15
rtrombin22: posts small blind 60
berilo.rama: posts big blind 120
*** HOLE CARDS ***
Dealt to flagao [7d Kc]
intelllect: folds 
flagao: folds 
Axxxidental: folds 
RodrigoCrvll: folds 
RedWhite86: raises 120 to 240
Gremista123™: folds 
rtrombin22: folds 
berilo.rama: folds 
Uncalled bet (120) returned to RedWhite86
RedWhite86 collected 420 from pot
RedWhite86: doesn't show hand 
*** SUMMARY ***
Total pot 420 | Rake 0 
Seat 1: intelllect folded before Flop (didn't bet)
Seat 3: flagao folded before Flop (didn't bet)
Seat 4: Axxxidental folded before Flop (didn't bet)
Seat 5: RodrigoCrvll folded before Flop (didn't bet)
Seat 6: RedWhite86 collected (420)
Seat 7: Gremista123™ (button) folded before Flop (didn't bet)
Seat 8: rtrombin22 (small blind) folded before Flop
Seat 9: berilo.rama (big blind) folded before Flop



PokerStars Hand #189312137419: Tournament #2369778109, $0.23+$0.02 USD Hold'em No Limit - Level V (60/120) - 2018/07/29 21:03:27 ET
Table '2369778109 1' 9-max Seat #8 is the button
Seat 1: intelllect (4298 in chips) 
Seat 3: flagao (4571 in chips) 
Seat 4: Axxxidental (2386 in chips) 
Seat 5: RodrigoCrvll (2588 in chips) 
Seat 6: RedWhite86 (3185 in chips) 
Seat 7: Gremista123™ (361 in chips) is sitting out
Seat 8: rtrombin22 (3130 in chips) is sitting out
Seat 9: berilo.rama (679 in chips) is sitting out
intelllect: posts the ante 15
flagao: posts the ante 15
Axxxidental: posts the ante 15
RodrigoCrvll: posts the ante 15
RedWhite86: posts the ante 15
Gremista123™: posts the ante 15
rtrombin22: posts the ante 15
berilo.rama: posts the ante 15
berilo.rama: posts small blind 60
intelllect: posts big blind 120
*** HOLE CARDS ***
Dealt to flagao [Ts 7d]
flagao: folds 
Axxxidental: folds 
RodrigoCrvll: folds 
RedWhite86: raises 120 to 240
Gremista123™: folds 
rtrombin22: folds 
berilo.rama: folds 
intelllect: folds 
Uncalled bet (120) returned to RedWhite86
RedWhite86 collected 420 from pot
RedWhite86: doesn't show hand 
*** SUMMARY ***
Total pot 420 | Rake 0 
Seat 1: intelllect (big blind) folded before Flop
Seat 3: flagao folded before Flop (didn't bet)
Seat 4: Axxxidental folded before Flop (didn't bet)
Seat 5: RodrigoCrvll folded before Flop (didn't bet)
Seat 6: RedWhite86 collected (420)
Seat 7: Gremista123™ folded before Flop (didn't bet)
Seat 8: rtrombin22 (button) folded before Flop (didn't bet)
Seat 9: berilo.rama (small blind) folded before Flop



PokerStars Hand #189312143433: Tournament #2369778109, $0.23+$0.02 USD Hold'em No Limit - Level V (60/120) - 2018/07/29 21:03:43 ET
Table '2369778109 1' 9-max Seat #9 is the button
Seat 1: intelllect (4163 in chips) 
Seat 3: flagao (4556 in chips) 
Seat 4: Axxxidental (2371 in chips) 
Seat 5: RodrigoCrvll (2573 in chips) 
Seat 6: RedWhite86 (3470 in chips) 
Seat 7: Gremista123™ (346 in chips) is sitting out
Seat 8: rtrombin22 (3115 in chips) is sitting out
Seat 9: berilo.rama (604 in chips) is sitting out
intelllect: posts the ante 15
flagao: posts the ante 15
Axxxidental: posts the ante 15
RodrigoCrvll: posts the ante 15
RedWhite86: posts the ante 15
Gremista123™: posts the ante 15
rtrombin22: posts the ante 15
berilo.rama: posts the ante 15
intelllect: posts small blind 60
flagao: posts big blind 120
*** HOLE CARDS ***
Dealt to flagao [2h Kc]
Axxxidental: folds 
RodrigoCrvll: folds 
RedWhite86: folds 
Gremista123™: folds 
rtrombin22: folds 
berilo.rama: folds 
intelllect: calls 60
flagao: checks 
*** FLOP *** [4s 6d Jc]
intelllect: checks 
flagao: bets 240
intelllect: folds 
Uncalled bet (240) returned to flagao
flagao collected 360 from pot
flagao: doesn't show hand 
*** SUMMARY ***
Total pot 360 | Rake 0 
Board [4s 6d Jc]
Seat 1: intelllect (small blind) folded on the Flop
Seat 3: flagao (big blind) collected (360)
Seat 4: Axxxidental folded before Flop (didn't bet)
Seat 5: RodrigoCrvll folded before Flop (didn't bet)
Seat 6: RedWhite86 folded before Flop (didn't bet)
Seat 7: Gremista123™ folded before Flop (didn't bet)
Seat 8: rtrombin22 folded before Flop (didn't bet)
Seat 9: berilo.rama (button) folded before Flop (didn't bet)



PokerStars Hand #189312158208: Tournament #2369778109, $0.23+$0.02 USD Hold'em No Limit - Level V (60/120) - 2018/07/29 21:04:22 ET
Table '2369778109 1' 9-max Seat #1 is the button
Seat 1: intelllect (4028 in chips) 
Seat 3: flagao (4781 in chips) 
Seat 4: Axxxidental (2356 in chips) 
Seat 5: RodrigoCrvll (2558 in chips) 
Seat 6: RedWhite86 (3455 in chips) 
Seat 7: Gremista123™ (331 in chips) is sitting out
Seat 9: berilo.rama (589 in chips) is sitting out
intelllect: posts the ante 15
flagao: posts the ante 15
Axxxidental: posts the ante 15
RodrigoCrvll: posts the ante 15
RedWhite86: posts the ante 15
Gremista123™: posts the ante 15
berilo.rama: posts the ante 15
flagao: posts small blind 60
Axxxidental: posts big blind 120
*** HOLE CARDS ***
Dealt to flagao [Jd Tc]
RodrigoCrvll: folds 
RedWhite86: folds 
Gremista123™: folds 
berilo.rama: folds 
intelllect: folds 
flagao: raises 120 to 240
Axxxidental: calls 120
*** FLOP *** [Qh 8s Kc]
flagao: bets 360
Axxxidental: folds 
Uncalled bet (360) returned to flagao
flagao collected 585 from pot
flagao: doesn't show hand 
*** SUMMARY ***
Total pot 585 | Rake 0 
Board [Qh 8s Kc]
Seat 1: intelllect (button) folded before Flop (didn't bet)
Seat 3: flagao (small blind) collected (585)
Seat 4: Axxxidental (big blind) folded on the Flop
Seat 5: RodrigoCrvll folded before Flop (didn't bet)
Seat 6: RedWhite86 folded before Flop (didn't bet)
Seat 7: Gremista123™ folded before Flop (didn't bet)
Seat 9: berilo.rama folded before Flop (didn't bet)



PokerStars Hand #189312182633: Tournament #2369778109, $0.23+$0.02 USD Hold'em No Limit - Level V (60/120) - 2018/07/29 21:05:10 ET
Table '2369778109 1' 9-max Seat #3 is the button
Seat 1: intelllect (4013 in chips) 
Seat 3: flagao (5111 in chips) 
Seat 4: Axxxidental (2101 in chips) 
Seat 5: RodrigoCrvll (2543 in chips) 
Seat 6: RedWhite86 (3440 in chips) 
Seat 7: Gremista123™ (316 in chips) is sitting out
Seat 9: berilo.rama (574 in chips) is sitting out
intelllect: posts the ante 15
flagao: posts the ante 15
Axxxidental: posts the ante 15
RodrigoCrvll: posts the ante 15
RedWhite86: posts the ante 15
Gremista123™: posts the ante 15
berilo.rama: posts the ante 15
Axxxidental: posts small blind 60
RodrigoCrvll: posts big blind 120
*** HOLE CARDS ***
Dealt to flagao [2c 4c]
RedWhite86: folds 
Gremista123™: folds 
berilo.rama: folds 
intelllect: folds 
flagao: folds 
Axxxidental: calls 60
RodrigoCrvll: checks 
*** FLOP *** [7h 6s Qd]
Axxxidental: checks 
RodrigoCrvll: bets 240
Axxxidental: folds 
Uncalled bet (240) returned to RodrigoCrvll
RodrigoCrvll collected 345 from pot
RodrigoCrvll: doesn't show hand 
*** SUMMARY ***
Total pot 345 | Rake 0 
Board [7h 6s Qd]
Seat 1: intelllect folded before Flop (didn't bet)
Seat 3: flagao (button) folded before Flop (didn't bet)
Seat 4: Axxxidental (small blind) folded on the Flop
Seat 5: RodrigoCrvll (big blind) collected (345)
Seat 6: RedWhite86 folded before Flop (didn't bet)
Seat 7: Gremista123™ folded before Flop (didn't bet)
Seat 9: berilo.rama folded before Flop (didn't bet)



PokerStars Hand #189312194589: Tournament #2369778109, $0.23+$0.02 USD Hold'em No Limit - Level V (60/120) - 2018/07/29 21:05:42 ET
Table '2369778109 1' 9-max Seat #4 is the button
Seat 1: intelllect (3998 in chips) 
Seat 3: flagao (5096 in chips) 
Seat 4: Axxxidental (1966 in chips) 
Seat 5: RodrigoCrvll (2753 in chips) 
Seat 6: RedWhite86 (3425 in chips) 
Seat 7: Gremista123™ (301 in chips) is sitting out
Seat 9: berilo.rama (559 in chips) is sitting out
intelllect: posts the ante 15
flagao: posts the ante 15
Axxxidental: posts the ante 15
RodrigoCrvll: posts the ante 15
RedWhite86: posts the ante 15
Gremista123™: posts the ante 15
berilo.rama: posts the ante 15
RodrigoCrvll: posts small blind 60
RedWhite86: posts big blind 120
*** HOLE CARDS ***
Dealt to flagao [Jd Ad]
Gremista123™: folds 
berilo.rama: folds 
intelllect: folds 
flagao: raises 120 to 240
Axxxidental: folds 
RodrigoCrvll: calls 180
RedWhite86: folds 
*** FLOP *** [3s Th 4h]
RodrigoCrvll: bets 480
flagao: folds 
Uncalled bet (480) returned to RodrigoCrvll
RodrigoCrvll collected 705 from pot
RodrigoCrvll: doesn't show hand 
*** SUMMARY ***
Total pot 705 | Rake 0 
Board [3s Th 4h]
Seat 1: intelllect folded before Flop (didn't bet)
Seat 3: flagao folded on the Flop
Seat 4: Axxxidental (button) folded before Flop (didn't bet)
Seat 5: RodrigoCrvll (small blind) collected (705)
Seat 6: RedWhite86 (big blind) folded before Flop
Seat 7: Gremista123™ folded before Flop (didn't bet)
Seat 9: berilo.rama folded before Flop (didn't bet)



PokerStars Hand #189312207682: Tournament #2369778109, $0.23+$0.02 USD Hold'em No Limit - Level V (60/120) - 2018/07/29 21:06:17 ET
Table '2369778109 1' 9-max Seat #5 is the button
Seat 1: intelllect (3983 in chips) 
Seat 3: flagao (4841 in chips) 
Seat 4: Axxxidental (1951 in chips) 
Seat 5: RodrigoCrvll (3203 in chips) 
Seat 6: RedWhite86 (3290 in chips) 
Seat 7: Gremista123™ (286 in chips) is sitting out
Seat 9: berilo.rama (544 in chips) is sitting out
intelllect: posts the ante 15
flagao: posts the ante 15
Axxxidental: posts the ante 15
RodrigoCrvll: posts the ante 15
RedWhite86: posts the ante 15
Gremista123™: posts the ante 15
berilo.rama: posts the ante 15
RedWhite86: posts small blind 60
Gremista123™: posts big blind 120
*** HOLE CARDS ***
Dealt to flagao [4h Kd]
berilo.rama: folds 
intelllect: folds 
flagao: folds 
Axxxidental: folds 
RodrigoCrvll: folds 
RedWhite86: raises 120 to 240
Gremista123™: folds 
Uncalled bet (120) returned to RedWhite86
RedWhite86 collected 345 from pot
RedWhite86: doesn't show hand 
*** SUMMARY ***
Total pot 345 | Rake 0 
Seat 1: intelllect folded before Flop (didn't bet)
Seat 3: flagao folded before Flop (didn't bet)
Seat 4: Axxxidental folded before Flop (didn't bet)
Seat 5: RodrigoCrvll (button) folded before Flop (didn't bet)
Seat 6: RedWhite86 (small blind) collected (345)
Seat 7: Gremista123™ (big blind) folded before Flop
Seat 9: berilo.rama folded before Flop (didn't bet)



PokerStars Hand #189312212021: Tournament #2369778109, $0.23+$0.02 USD Hold'em No Limit - Level V (60/120) - 2018/07/29 21:06:29 ET
Table '2369778109 1' 9-max Seat #6 is the button
Seat 1: intelllect (3968 in chips) 
Seat 3: flagao (4826 in chips) 
Seat 4: Axxxidental (1936 in chips) 
Seat 5: RodrigoCrvll (3188 in chips) 
Seat 6: RedWhite86 (3500 in chips) 
Seat 7: Gremista123™ (151 in chips) is sitting out
Seat 9: berilo.rama (529 in chips) is sitting out
intelllect: posts the ante 15
flagao: posts the ante 15
Axxxidental: posts the ante 15
RodrigoCrvll: posts the ante 15
RedWhite86: posts the ante 15
Gremista123™: posts the ante 15
berilo.rama: posts the ante 15
Gremista123™: posts small blind 60
berilo.rama: posts big blind 120
*** HOLE CARDS ***
Dealt to flagao [2h 2d]
berilo.rama has returned
intelllect: folds 
flagao: raises 120 to 240
Axxxidental: folds 
RodrigoCrvll: folds 
RedWhite86: folds 
Gremista123™: folds 
berilo.rama: folds 
Uncalled bet (120) returned to flagao
flagao collected 405 from pot
flagao: doesn't show hand 
*** SUMMARY ***
Total pot 405 | Rake 0 
Seat 1: intelllect folded before Flop (didn't bet)
Seat 3: flagao collected (405)
Seat 4: Axxxidental folded before Flop (didn't bet)
Seat 5: RodrigoCrvll folded before Flop (didn't bet)
Seat 6: RedWhite86 (button) folded before Flop (didn't bet)
Seat 7: Gremista123™ (small blind) folded before Flop
Seat 9: berilo.rama (big blind) folded before Flop



PokerStars Hand #189312223030: Tournament #2369778109, $0.23+$0.02 USD Hold'em No Limit - Level V (60/120) - 2018/07/29 21:06:58 ET
Table '2369778109 1' 9-max Seat #7 is the button
Seat 1: intelllect (3953 in chips) 
Seat 3: flagao (5096 in chips) 
Seat 4: Axxxidental (1921 in chips) 
Seat 5: RodrigoCrvll (3173 in chips) 
Seat 6: RedWhite86 (3485 in chips) 
Seat 7: Gremista123™ (76 in chips) is sitting out
Seat 9: berilo.rama (394 in chips) 
intelllect: posts the ante 15
flagao: posts the ante 15
Axxxidental: posts the ante 15
RodrigoCrvll: posts the ante 15
RedWhite86: posts the ante 15
Gremista123™: posts the ante 15
berilo.rama: posts the ante 15
berilo.rama: posts small blind 60
intelllect: posts big blind 120
*** HOLE CARDS ***
Dealt to flagao [5c 5d]
flagao: raises 120 to 240
Axxxidental: folds 
RodrigoCrvll: folds 
RedWhite86: folds 
Gremista123™: folds 
berilo.rama: raises 139 to 379 and is all-in
intelllect: folds 
flagao: calls 139
*** FLOP *** [3h 4d Kc]
*** TURN *** [3h 4d Kc] [2d]
*** RIVER *** [3h 4d Kc 2d] [Jd]
*** SHOW DOWN ***
berilo.rama: shows [Qc 4c] (a pair of Fours)
flagao: shows [5c 5d] (a pair of Fives)
flagao collected 983 from pot
berilo.rama finished the tournament in 20th place
*** SUMMARY ***
Total pot 983 | Rake 0 
Board [3h 4d Kc 2d Jd]
Seat 1: intelllect (big blind) folded before Flop
Seat 3: flagao showed [5c 5d] and won (983) with a pair of Fives
Seat 4: Axxxidental folded before Flop (didn't bet)
Seat 5: RodrigoCrvll folded before Flop (didn't bet)
Seat 6: RedWhite86 folded before Flop (didn't bet)
Seat 7: Gremista123™ (button) folded before Flop (didn't bet)
Seat 9: berilo.rama (small blind) showed [Qc 4c] and lost with a pair of Fours



PokerStars Hand #189312238742: Tournament #2369778109, $0.23+$0.02 USD Hold'em No Limit - Level VI (80/160) - 2018/07/29 21:07:40 ET
Table '2369778109 1' 9-max Seat #1 is the button
Seat 1: intelllect (3818 in chips) 
Seat 3: flagao (5685 in chips) 
Seat 4: Axxxidental (1906 in chips) 
Seat 5: RodrigoCrvll (3158 in chips) 
Seat 6: RedWhite86 (3470 in chips) 
Seat 7: Gremista123™ (61 in chips) is sitting out
intelllect: posts the ante 20
flagao: posts the ante 20
Axxxidental: posts the ante 20
RodrigoCrvll: posts the ante 20
RedWhite86: posts the ante 20
Gremista123™: posts the ante 20
flagao: posts small blind 80
Axxxidental: posts big blind 160
*** HOLE CARDS ***
Dealt to flagao [Qs Tc]
RodrigoCrvll: folds 
RedWhite86: folds 
Gremista123™: folds 
intelllect: raises 160 to 320
flagao: folds 
Axxxidental: folds 
Uncalled bet (160) returned to intelllect
intelllect collected 520 from pot
intelllect: doesn't show hand 
*** SUMMARY ***
Total pot 520 | Rake 0 
Seat 1: intelllect (button) collected (520)
Seat 3: flagao (small blind) folded before Flop
Seat 4: Axxxidental (big blind) folded before Flop
Seat 5: RodrigoCrvll folded before Flop (didn't bet)
Seat 6: RedWhite86 folded before Flop (didn't bet)
Seat 7: Gremista123™ folded before Flop (didn't bet)



PokerStars Hand #189312249576: Tournament #2369778109, $0.23+$0.02 USD Hold'em No Limit - Level VI (80/160) - 2018/07/29 21:08:09 ET
Table '2369778109 1' 9-max Seat #3 is the button
Seat 1: intelllect (4158 in chips) 
Seat 3: flagao (5585 in chips) 
Seat 4: Axxxidental (1726 in chips) 
Seat 5: RodrigoCrvll (3138 in chips) 
Seat 6: RedWhite86 (3450 in chips) 
Seat 7: Gremista123™ (41 in chips) is sitting out
intelllect: posts the ante 20
flagao: posts the ante 20
Axxxidental: posts the ante 20
RodrigoCrvll: posts the ante 20
RedWhite86: posts the ante 20
Gremista123™: posts the ante 20
Axxxidental: posts small blind 80
RodrigoCrvll: posts big blind 160
*** HOLE CARDS ***
Dealt to flagao [9d 5s]
RedWhite86: folds 
Gremista123™: folds 
intelllect: folds 
flagao: folds 
Axxxidental: calls 80
RodrigoCrvll: checks 
*** FLOP *** [Qd 4h 3s]
Axxxidental: checks 
RodrigoCrvll: checks 
*** TURN *** [Qd 4h 3s] [4d]
Axxxidental: checks 
RodrigoCrvll: checks 
*** RIVER *** [Qd 4h 3s 4d] [8d]
Axxxidental: bets 194
RodrigoCrvll: folds 
Uncalled bet (194) returned to Axxxidental
Axxxidental collected 440 from pot
*** SUMMARY ***
Total pot 440 | Rake 0 
Board [Qd 4h 3s 4d 8d]
Seat 1: intelllect folded before Flop (didn't bet)
Seat 3: flagao (button) folded before Flop (didn't bet)
Seat 4: Axxxidental (small blind) collected (440)
Seat 5: RodrigoCrvll (big blind) folded on the River
Seat 6: RedWhite86 folded before Flop (didn't bet)
Seat 7: Gremista123™ folded before Flop (didn't bet)



PokerStars Hand #189312261273: Tournament #2369778109, $0.23+$0.02 USD Hold'em No Limit - Level VI (80/160) - 2018/07/29 21:08:41 ET
Table '2369778109 1' 9-max Seat #4 is the button
Seat 1: intelllect (4138 in chips) 
Seat 3: flagao (5565 in chips) 
Seat 4: Axxxidental (1986 in chips) 
Seat 5: RodrigoCrvll (2958 in chips) 
Seat 6: RedWhite86 (3430 in chips) 
Seat 7: Gremista123™ (21 in chips) is sitting out
intelllect: posts the ante 20
flagao: posts the ante 20
Axxxidental: posts the ante 20
RodrigoCrvll: posts the ante 20
RedWhite86: posts the ante 20
Gremista123™: posts the ante 20
RodrigoCrvll: posts small blind 80
RedWhite86: posts big blind 160
*** HOLE CARDS ***
Dealt to flagao [Jh Tc]
Gremista123™: folds 
intelllect: folds 
flagao: folds 
Axxxidental: folds 
RodrigoCrvll: folds 
Uncalled bet (80) returned to RedWhite86
RedWhite86 collected 280 from pot
RedWhite86: doesn't show hand 
*** SUMMARY ***
Total pot 280 | Rake 0 
Seat 1: intelllect folded before Flop (didn't bet)
Seat 3: flagao folded before Flop (didn't bet)
Seat 4: Axxxidental (button) folded before Flop (didn't bet)
Seat 5: RodrigoCrvll (small blind) folded before Flop
Seat 6: RedWhite86 (big blind) collected (280)
Seat 7: Gremista123™ folded before Flop (didn't bet)



PokerStars Hand #189312267419: Tournament #2369778109, $0.23+$0.02 USD Hold'em No Limit - Level VI (80/160) - 2018/07/29 21:08:58 ET
Table '2369778109 1' 9-max Seat #5 is the button
Seat 1: intelllect (4118 in chips) 
Seat 3: flagao (5545 in chips) 
Seat 4: Axxxidental (1966 in chips) 
Seat 5: RodrigoCrvll (2858 in chips) 
Seat 6: RedWhite86 (3610 in chips) 
Seat 7: Gremista123™ (1 in chips) is sitting out
intelllect: posts the ante 20
flagao: posts the ante 20
Axxxidental: posts the ante 20
RodrigoCrvll: posts the ante 20
RedWhite86: posts the ante 20
Gremista123™: posts the ante 1 and is all-in
RedWhite86: posts small blind 80
*** HOLE CARDS ***
Dealt to flagao [Qs 3c]
intelllect: folds 
flagao: folds 
Axxxidental: folds 
RodrigoCrvll: raises 240 to 320
RedWhite86: folds 
Gremista123™: folds 
Uncalled bet (240) returned to RodrigoCrvll
RodrigoCrvll collected 261 from pot
Gremista123™ finished the tournament in 19th place
RodrigoCrvll: doesn't show hand 
*** SUMMARY ***
Total pot 261 | Rake 0 
Seat 1: intelllect folded before Flop (didn't bet)
Seat 3: flagao folded before Flop (didn't bet)
Seat 4: Axxxidental folded before Flop (didn't bet)
Seat 5: RodrigoCrvll (button) collected (261)
Seat 6: RedWhite86 (small blind) folded before Flop
Seat 7: Gremista123™ folded before Flop (didn't bet)



PokerStars Hand #189312288780: Tournament #2369778109, $0.23+$0.02 USD Hold'em No Limit - Level VI (80/160) - 2018/07/29 21:09:56 ET
Table '2369778109 3' 9-max Seat #5 is the button
Seat 1: MegadethChug (4438 in chips) 
Seat 2: rtrombin22 (2765 in chips) 
Seat 3: 89.N.M.W.06 (4202 in chips) 
Seat 4: flagao (5525 in chips) 
Seat 5: jamaralnt (3932 in chips) 
Seat 6: kaiquebmxx (2505 in chips) 
Seat 7: chaq*n voy (4909 in chips) 
Seat 8: RodrigoCrvll (3019 in chips) 
Seat 9: cowbicha (6183 in chips) 
MegadethChug: posts the ante 20
rtrombin22: posts the ante 20
89.N.M.W.06: posts the ante 20
flagao: posts the ante 20
jamaralnt: posts the ante 20
kaiquebmxx: posts the ante 20
chaq*n voy: posts the ante 20
RodrigoCrvll: posts the ante 20
cowbicha: posts the ante 20
kaiquebmxx: posts small blind 80
chaq*n voy: posts big blind 160
*** HOLE CARDS ***
Dealt to flagao [5s Ks]
RodrigoCrvll: folds 
cowbicha: folds 
MegadethChug: folds 
rtrombin22: folds 
89.N.M.W.06: folds 
flagao: raises 160 to 320
jamaralnt: folds 
kaiquebmxx: folds 
chaq*n voy: folds 
Uncalled bet (160) returned to flagao
flagao collected 580 from pot
flagao: doesn't show hand 
*** SUMMARY ***
Total pot 580 | Rake 0 
Seat 1: MegadethChug folded before Flop (didn't bet)
Seat 2: rtrombin22 folded before Flop (didn't bet)
Seat 3: 89.N.M.W.06 folded before Flop (didn't bet)
Seat 4: flagao collected (580)
Seat 5: jamaralnt (button) folded before Flop (didn't bet)
Seat 6: kaiquebmxx (small blind) folded before Flop
Seat 7: chaq*n voy (big blind) folded before Flop
Seat 8: RodrigoCrvll folded before Flop (didn't bet)
Seat 9: cowbicha folded before Flop (didn't bet)



PokerStars Hand #189312309869: Tournament #2369778109, $0.23+$0.02 USD Hold'em No Limit - Level VI (80/160) - 2018/07/29 21:10:53 ET
Table '2369778109 3' 9-max Seat #6 is the button
Seat 1: MegadethChug (4418 in chips) 
Seat 2: rtrombin22 (2745 in chips) 
Seat 3: 89.N.M.W.06 (4182 in chips) 
Seat 4: flagao (5925 in chips) 
Seat 5: jamaralnt (3912 in chips) 
Seat 6: kaiquebmxx (2405 in chips) 
Seat 7: chaq*n voy (4729 in chips) 
Seat 8: RodrigoCrvll (2999 in chips) 
Seat 9: cowbicha (6163 in chips) 
MegadethChug: posts the ante 20
rtrombin22: posts the ante 20
89.N.M.W.06: posts the ante 20
flagao: posts the ante 20
jamaralnt: posts the ante 20
kaiquebmxx: posts the ante 20
chaq*n voy: posts the ante 20
RodrigoCrvll: posts the ante 20
cowbicha: posts the ante 20
chaq*n voy: posts small blind 80
RodrigoCrvll: posts big blind 160
*** HOLE CARDS ***
Dealt to flagao [Jd Qd]
cowbicha: folds 
MegadethChug: raises 160 to 320
rtrombin22: calls 320
89.N.M.W.06: folds 
flagao: calls 320
jamaralnt: folds 
kaiquebmxx: calls 320
chaq*n voy: calls 240
RodrigoCrvll: folds 
*** FLOP *** [8d 5s 7h]
chaq*n voy: checks 
MegadethChug: checks 
rtrombin22: bets 1067
flagao: folds 
kaiquebmxx: folds 
chaq*n voy: raises 3322 to 4389 and is all-in
MegadethChug: folds 
rtrombin22: calls 1338 and is all-in
Uncalled bet (1984) returned to chaq*n voy
*** TURN *** [8d 5s 7h] [7d]
*** RIVER *** [8d 5s 7h 7d] [2h]
*** SHOW DOWN ***
chaq*n voy: shows [8h 9h] (two pair, Eights and Sevens)
rtrombin22: shows [Ad Ah] (two pair, Aces and Sevens)
rtrombin22 collected 6750 from pot
*** SUMMARY ***
Total pot 6750 | Rake 0 
Board [8d 5s 7h 7d 2h]
Seat 1: MegadethChug folded on the Flop
Seat 2: rtrombin22 showed [Ad Ah] and won (6750) with two pair, Aces and Sevens
Seat 3: 89.N.M.W.06 folded before Flop (didn't bet)
Seat 4: flagao folded on the Flop
Seat 5: jamaralnt folded before Flop (didn't bet)
Seat 6: kaiquebmxx (button) folded on the Flop
Seat 7: chaq*n voy (small blind) showed [8h 9h] and lost with two pair, Eights and Sevens
Seat 8: RodrigoCrvll (big blind) folded before Flop
Seat 9: cowbicha folded before Flop (didn't bet)



PokerStars Hand #189312344766: Tournament #2369778109, $0.23+$0.02 USD Hold'em No Limit - Level VI (80/160) - 2018/07/29 21:12:29 ET
Table '2369778109 3' 9-max Seat #7 is the button
Seat 1: MegadethChug (4078 in chips) 
Seat 2: rtrombin22 (6750 in chips) 
Seat 3: 89.N.M.W.06 (4162 in chips) 
Seat 4: flagao (5585 in chips) 
Seat 5: jamaralnt (3892 in chips) 
Seat 6: kaiquebmxx (2065 in chips) 
Seat 7: chaq*n voy (1984 in chips) 
Seat 8: RodrigoCrvll (2819 in chips) 
Seat 9: cowbicha (6143 in chips) 
MegadethChug: posts the ante 20
rtrombin22: posts the ante 20
89.N.M.W.06: posts the ante 20
flagao: posts the ante 20
jamaralnt: posts the ante 20
kaiquebmxx: posts the ante 20
chaq*n voy: posts the ante 20
RodrigoCrvll: posts the ante 20
cowbicha: posts the ante 20
RodrigoCrvll: posts small blind 80
cowbicha: posts big blind 160
*** HOLE CARDS ***
Dealt to flagao [2c 2h]
MegadethChug: calls 160
rtrombin22: folds 
89.N.M.W.06: folds 
flagao: raises 160 to 320
jamaralnt: folds 
kaiquebmxx: folds 
chaq*n voy: calls 320
RodrigoCrvll: folds 
cowbicha: folds 
MegadethChug: calls 160
*** FLOP *** [Jd 6s As]
MegadethChug: checks 
flagao: checks 
chaq*n voy: checks 
*** TURN *** [Jd 6s As] [Ac]
MegadethChug: checks 
flagao: bets 800
chaq*n voy: folds 
MegadethChug: folds 
Uncalled bet (800) returned to flagao
flagao collected 1380 from pot
flagao: doesn't show hand 
*** SUMMARY ***
Total pot 1380 | Rake 0 
Board [Jd 6s As Ac]
Seat 1: MegadethChug folded on the Turn
Seat 2: rtrombin22 folded before Flop (didn't bet)
Seat 3: 89.N.M.W.06 folded before Flop (didn't bet)
Seat 4: flagao collected (1380)
Seat 5: jamaralnt folded before Flop (didn't bet)
Seat 6: kaiquebmxx folded before Flop (didn't bet)
Seat 7: chaq*n voy (button) folded on the Turn
Seat 8: RodrigoCrvll (small blind) folded before Flop
Seat 9: cowbicha (big blind) folded before Flop



PokerStars Hand #189312372178: Tournament #2369778109, $0.23+$0.02 USD Hold'em No Limit - Level VI (80/160) - 2018/07/29 21:13:45 ET
Table '2369778109 3' 9-max Seat #8 is the button
Seat 1: MegadethChug (3738 in chips) 
Seat 2: rtrombin22 (6730 in chips) 
Seat 3: 89.N.M.W.06 (4142 in chips) 
Seat 4: flagao (6625 in chips) 
Seat 5: jamaralnt (3872 in chips) 
Seat 6: kaiquebmxx (2045 in chips) 
Seat 7: chaq*n voy (1644 in chips) 
Seat 8: RodrigoCrvll (2719 in chips) 
Seat 9: cowbicha (5963 in chips) 
MegadethChug: posts the ante 20
rtrombin22: posts the ante 20
89.N.M.W.06: posts the ante 20
flagao: posts the ante 20
jamaralnt: posts the ante 20
kaiquebmxx: posts the ante 20
chaq*n voy: posts the ante 20
RodrigoCrvll: posts the ante 20
cowbicha: posts the ante 20
cowbicha: posts small blind 80
MegadethChug: posts big blind 160
*** HOLE CARDS ***
Dealt to flagao [5s Jd]
rtrombin22: folds 
89.N.M.W.06: folds 
flagao: folds 
jamaralnt: raises 160 to 320
kaiquebmxx: folds 
chaq*n voy: calls 320
RodrigoCrvll: folds 
cowbicha: folds 
MegadethChug: folds 
*** FLOP *** [Qs Jc 4h]
jamaralnt: bets 318
chaq*n voy: calls 318
*** TURN *** [Qs Jc 4h] [9s]
jamaralnt: bets 509
chaq*n voy: raises 477 to 986 and is all-in
jamaralnt: calls 477
*** RIVER *** [Qs Jc 4h 9s] [5c]
*** SHOW DOWN ***
jamaralnt: shows [Qd Ah] (a pair of Queens)
chaq*n voy: shows [Kc Jh] (a pair of Jacks)
jamaralnt collected 3668 from pot
chaq*n voy finished the tournament in 18th place
*** SUMMARY ***
Total pot 3668 | Rake 0 
Board [Qs Jc 4h 9s 5c]
Seat 1: MegadethChug (big blind) folded before Flop
Seat 2: rtrombin22 folded before Flop (didn't bet)
Seat 3: 89.N.M.W.06 folded before Flop (didn't bet)
Seat 4: flagao folded before Flop (didn't bet)
Seat 5: jamaralnt showed [Qd Ah] and won (3668) with a pair of Queens
Seat 6: kaiquebmxx folded before Flop (didn't bet)
Seat 7: chaq*n voy showed [Kc Jh] and lost with a pair of Jacks
Seat 8: RodrigoCrvll (button) folded before Flop (didn't bet)
Seat 9: cowbicha (small blind) folded before Flop



PokerStars Hand #189312388843: Tournament #2369778109, $0.23+$0.02 USD Hold'em No Limit - Level VI (80/160) - 2018/07/29 21:14:31 ET
Table '2369778109 3' 9-max Seat #9 is the button
Seat 1: MegadethChug (3558 in chips) 
Seat 2: rtrombin22 (6710 in chips) 
Seat 3: 89.N.M.W.06 (4122 in chips) 
Seat 4: flagao (6605 in chips) 
Seat 5: jamaralnt (5896 in chips) 
Seat 6: kaiquebmxx (2025 in chips) 
Seat 8: RodrigoCrvll (2699 in chips) 
Seat 9: cowbicha (5863 in chips) 
MegadethChug: posts the ante 20
rtrombin22: posts the ante 20
89.N.M.W.06: posts the ante 20
flagao: posts the ante 20
jamaralnt: posts the ante 20
kaiquebmxx: posts the ante 20
RodrigoCrvll: posts the ante 20
cowbicha: posts the ante 20
MegadethChug: posts small blind 80
rtrombin22: posts big blind 160
*** HOLE CARDS ***
Dealt to flagao [Ks 5h]
89.N.M.W.06: raises 320 to 480
flagao: folds 
jamaralnt: folds 
kaiquebmxx: folds 
RodrigoCrvll: folds 
cowbicha: folds 
MegadethChug: folds 
rtrombin22: folds 
Uncalled bet (320) returned to 89.N.M.W.06
89.N.M.W.06 collected 560 from pot
*** SUMMARY ***
Total pot 560 | Rake 0 
Seat 1: MegadethChug (small blind) folded before Flop
Seat 2: rtrombin22 (big blind) folded before Flop
Seat 3: 89.N.M.W.06 collected (560)
Seat 4: flagao folded before Flop (didn't bet)
Seat 5: jamaralnt folded before Flop (didn't bet)
Seat 6: kaiquebmxx folded before Flop (didn't bet)
Seat 8: RodrigoCrvll folded before Flop (didn't bet)
Seat 9: cowbicha (button) folded before Flop (didn't bet)



PokerStars Hand #189312401033: Tournament #2369778109, $0.23+$0.02 USD Hold'em No Limit - Level VI (80/160) - 2018/07/29 21:15:05 ET
Table '2369778109 3' 9-max Seat #1 is the button
Seat 1: MegadethChug (3458 in chips) 
Seat 2: rtrombin22 (6530 in chips) 
Seat 3: 89.N.M.W.06 (4502 in chips) 
Seat 4: flagao (6585 in chips) 
Seat 5: jamaralnt (5876 in chips) 
Seat 6: kaiquebmxx (2005 in chips) 
Seat 8: RodrigoCrvll (2679 in chips) 
Seat 9: cowbicha (5843 in chips) 
MegadethChug: posts the ante 20
rtrombin22: posts the ante 20
89.N.M.W.06: posts the ante 20
flagao: posts the ante 20
jamaralnt: posts the ante 20
kaiquebmxx: posts the ante 20
RodrigoCrvll: posts the ante 20
cowbicha: posts the ante 20
rtrombin22: posts small blind 80
89.N.M.W.06: posts big blind 160
*** HOLE CARDS ***
Dealt to flagao [8h Ad]
flagao: folds 
jamaralnt: folds 
kaiquebmxx: raises 160 to 320
RodrigoCrvll: folds 
cowbicha: calls 320
MegadethChug: folds 
rtrombin22: folds 
89.N.M.W.06 is disconnected 
89.N.M.W.06 is connected 
89.N.M.W.06: raises 4162 to 4482 and is all-in
kaiquebmxx: folds 
cowbicha: folds 
Uncalled bet (4162) returned to 89.N.M.W.06
89.N.M.W.06 collected 1200 from pot
*** SUMMARY ***
Total pot 1200 | Rake 0 
Seat 1: MegadethChug (button) folded before Flop (didn't bet)
Seat 2: rtrombin22 (small blind) folded before Flop
Seat 3: 89.N.M.W.06 (big blind) collected (1200)
Seat 4: flagao folded before Flop (didn't bet)
Seat 5: jamaralnt folded before Flop (didn't bet)
Seat 6: kaiquebmxx folded before Flop
Seat 8: RodrigoCrvll folded before Flop (didn't bet)
Seat 9: cowbicha folded before Flop



PokerStars Hand #189312434206: Tournament #2369778109, $0.23+$0.02 USD Hold'em No Limit - Level VI (80/160) - 2018/07/29 21:16:37 ET
Table '2369778109 3' 9-max Seat #2 is the button
Seat 1: MegadethChug (3438 in chips) 
Seat 2: rtrombin22 (6430 in chips) 
Seat 3: 89.N.M.W.06 (5362 in chips) 
Seat 4: flagao (6565 in chips) 
Seat 5: jamaralnt (5856 in chips) 
Seat 6: kaiquebmxx (1665 in chips) 
Seat 8: RodrigoCrvll (2659 in chips) 
Seat 9: cowbicha (5503 in chips) 
MegadethChug: posts the ante 20
rtrombin22: posts the ante 20
89.N.M.W.06: posts the ante 20
flagao: posts the ante 20
jamaralnt: posts the ante 20
kaiquebmxx: posts the ante 20
RodrigoCrvll: posts the ante 20
cowbicha: posts the ante 20
89.N.M.W.06: posts small blind 80
flagao: posts big blind 160
*** HOLE CARDS ***
Dealt to flagao [3s 3h]
jamaralnt: raises 160 to 320
kaiquebmxx: folds 
RodrigoCrvll: folds 
cowbicha: folds 
MegadethChug: calls 320
rtrombin22: folds 
89.N.M.W.06: raises 5022 to 5342 and is all-in
flagao: folds 
jamaralnt: folds 
MegadethChug: folds 
Uncalled bet (5022) returned to 89.N.M.W.06
89.N.M.W.06 collected 1280 from pot
89.N.M.W.06: doesn't show hand 
*** SUMMARY ***
Total pot 1280 | Rake 0 
Seat 1: MegadethChug folded before Flop
Seat 2: rtrombin22 (button) folded before Flop (didn't bet)
Seat 3: 89.N.M.W.06 (small blind) collected (1280)
Seat 4: flagao (big blind) folded before Flop
Seat 5: jamaralnt folded before Flop
Seat 6: kaiquebmxx folded before Flop (didn't bet)
Seat 8: RodrigoCrvll folded before Flop (didn't bet)
Seat 9: cowbicha folded before Flop (didn't bet)



PokerStars Hand #189312449972: Tournament #2369778109, $0.23+$0.02 USD Hold'em No Limit - Level VI (80/160) - 2018/07/29 21:17:21 ET
Table '2369778109 3' 9-max Seat #3 is the button
Seat 1: MegadethChug (3098 in chips) 
Seat 2: rtrombin22 (6410 in chips) 
Seat 3: 89.N.M.W.06 (6302 in chips) 
Seat 4: flagao (6385 in chips) 
Seat 5: jamaralnt (5516 in chips) 
Seat 6: kaiquebmxx (1645 in chips) 
Seat 8: RodrigoCrvll (2639 in chips) 
Seat 9: cowbicha (5483 in chips) 
MegadethChug: posts the ante 20
rtrombin22: posts the ante 20
89.N.M.W.06: posts the ante 20
flagao: posts the ante 20
jamaralnt: posts the ante 20
kaiquebmxx: posts the ante 20
RodrigoCrvll: posts the ante 20
cowbicha: posts the ante 20
flagao: posts small blind 80
jamaralnt: posts big blind 160
*** HOLE CARDS ***
Dealt to flagao [7s 3d]
kaiquebmxx: raises 1465 to 1625 and is all-in
RodrigoCrvll: folds 
cowbicha: folds 
MegadethChug: folds 
rtrombin22: folds 
89.N.M.W.06: folds 
flagao: folds 
jamaralnt: calls 1465
*** FLOP *** [Tc 8c 9d]
*** TURN *** [Tc 8c 9d] [7c]
*** RIVER *** [Tc 8c 9d 7c] [As]
*** SHOW DOWN ***
jamaralnt: shows [Td Ac] (two pair, Aces and Tens)
kaiquebmxx: shows [Kh Ts] (a pair of Tens)
jamaralnt collected 3490 from pot
kaiquebmxx finished the tournament in 17th place
*** SUMMARY ***
Total pot 3490 | Rake 0 
Board [Tc 8c 9d 7c As]
Seat 1: MegadethChug folded before Flop (didn't bet)
Seat 2: rtrombin22 folded before Flop (didn't bet)
Seat 3: 89.N.M.W.06 (button) folded before Flop (didn't bet)
Seat 4: flagao (small blind) folded before Flop
Seat 5: jamaralnt (big blind) showed [Td Ac] and won (3490) with two pair, Aces and Tens
Seat 6: kaiquebmxx showed [Kh Ts] and lost with a pair of Tens
Seat 8: RodrigoCrvll folded before Flop (didn't bet)
Seat 9: cowbicha folded before Flop (didn't bet)



PokerStars Hand #189312463704: Tournament #2369778109, $0.23+$0.02 USD Hold'em No Limit - Level VII (100/200) - 2018/07/29 21:17:59 ET
Table '2369778109 3' 9-max Seat #4 is the button
Seat 1: MegadethChug (3078 in chips) 
Seat 2: rtrombin22 (6390 in chips) 
Seat 3: 89.N.M.W.06 (6282 in chips) 
Seat 4: flagao (6285 in chips) 
Seat 5: jamaralnt (7361 in chips) 
Seat 8: RodrigoCrvll (2619 in chips) 
Seat 9: cowbicha (5463 in chips) 
MegadethChug: posts the ante 25
rtrombin22: posts the ante 25
89.N.M.W.06: posts the ante 25
flagao: posts the ante 25
jamaralnt: posts the ante 25
RodrigoCrvll: posts the ante 25
cowbicha: posts the ante 25
jamaralnt: posts small blind 100
RodrigoCrvll: posts big blind 200
*** HOLE CARDS ***
Dealt to flagao [Th Js]
cowbicha: folds 
MegadethChug: folds 
rtrombin22: folds 
89.N.M.W.06: folds 
flagao: raises 300 to 500
jamaralnt: folds 
RodrigoCrvll: folds 
Uncalled bet (300) returned to flagao
flagao collected 675 from pot
flagao: doesn't show hand 
*** SUMMARY ***
Total pot 675 | Rake 0 
Seat 1: MegadethChug folded before Flop (didn't bet)
Seat 2: rtrombin22 folded before Flop (didn't bet)
Seat 3: 89.N.M.W.06 folded before Flop (didn't bet)
Seat 4: flagao (button) collected (675)
Seat 5: jamaralnt (small blind) folded before Flop
Seat 8: RodrigoCrvll (big blind) folded before Flop
Seat 9: cowbicha folded before Flop (didn't bet)



PokerStars Hand #189312473528: Tournament #2369778109, $0.23+$0.02 USD Hold'em No Limit - Level VII (100/200) - 2018/07/29 21:18:26 ET
Table '2369778109 3' 9-max Seat #5 is the button
Seat 1: MegadethChug (3053 in chips) 
Seat 2: rtrombin22 (6365 in chips) 
Seat 3: 89.N.M.W.06 (6257 in chips) 
Seat 4: flagao (6735 in chips) 
Seat 5: jamaralnt (7236 in chips) 
Seat 8: RodrigoCrvll (2394 in chips) 
Seat 9: cowbicha (5438 in chips) 
MegadethChug: posts the ante 25
rtrombin22: posts the ante 25
89.N.M.W.06: posts the ante 25
flagao: posts the ante 25
jamaralnt: posts the ante 25
RodrigoCrvll: posts the ante 25
cowbicha: posts the ante 25
RodrigoCrvll: posts small blind 100
cowbicha: posts big blind 200
*** HOLE CARDS ***
Dealt to flagao [9c Qc]
MegadethChug: folds 
rtrombin22: folds 
89.N.M.W.06: calls 200
flagao: folds 
jamaralnt: raises 400 to 600
RodrigoCrvll: folds 
cowbicha: folds 
89.N.M.W.06: raises 5632 to 6232 and is all-in
jamaralnt: folds 
Uncalled bet (5632) returned to 89.N.M.W.06
89.N.M.W.06 collected 1675 from pot
89.N.M.W.06: doesn't show hand 
*** SUMMARY ***
Total pot 1675 | Rake 0 
Seat 1: MegadethChug folded before Flop (didn't bet)
Seat 2: rtrombin22 folded before Flop (didn't bet)
Seat 3: 89.N.M.W.06 collected (1675)
Seat 4: flagao folded before Flop (didn't bet)
Seat 5: jamaralnt (button) folded before Flop
Seat 8: RodrigoCrvll (small blind) folded before Flop
Seat 9: cowbicha (big blind) folded before Flop



PokerStars Hand #189312501074: Tournament #2369778109, $0.23+$0.02 USD Hold'em No Limit - Level VII (100/200) - 2018/07/29 21:19:44 ET
Table '2369778109 3' 9-max Seat #8 is the button
Seat 1: MegadethChug (3028 in chips) 
Seat 2: rtrombin22 (6340 in chips) 
Seat 3: 89.N.M.W.06 (7307 in chips) 
Seat 4: flagao (6710 in chips) 
Seat 5: jamaralnt (6611 in chips) 
Seat 6: amand272 (2886 in chips) 
Seat 8: RodrigoCrvll (2269 in chips) 
Seat 9: cowbicha (5213 in chips) 
MegadethChug: posts the ante 25
rtrombin22: posts the ante 25
89.N.M.W.06: posts the ante 25
flagao: posts the ante 25
jamaralnt: posts the ante 25
amand272: posts the ante 25
RodrigoCrvll: posts the ante 25
cowbicha: posts the ante 25
cowbicha: posts small blind 100
MegadethChug: posts big blind 200
*** HOLE CARDS ***
Dealt to flagao [Kd 9c]
rtrombin22: folds 
89.N.M.W.06: raises 7082 to 7282 and is all-in
flagao: folds 
jamaralnt: folds 
amand272: folds 
RodrigoCrvll: folds 
cowbicha: calls 5088 and is all-in
MegadethChug: folds 
Uncalled bet (2094) returned to 89.N.M.W.06
*** FLOP *** [5s 8h Qc]
*** TURN *** [5s 8h Qc] [As]
*** RIVER *** [5s 8h Qc As] [Ts]
*** SHOW DOWN ***
cowbicha: shows [Ad Tc] (two pair, Aces and Tens)
89.N.M.W.06: shows [Jh Jc] (a pair of Jacks)
cowbicha collected 10776 from pot
*** SUMMARY ***
Total pot 10776 | Rake 0 
Board [5s 8h Qc As Ts]
Seat 1: MegadethChug (big blind) folded before Flop
Seat 2: rtrombin22 folded before Flop (didn't bet)
Seat 3: 89.N.M.W.06 showed [Jh Jc] and lost with a pair of Jacks
Seat 4: flagao folded before Flop (didn't bet)
Seat 5: jamaralnt folded before Flop (didn't bet)
Seat 6: amand272 folded before Flop (didn't bet)
Seat 8: RodrigoCrvll (button) folded before Flop (didn't bet)
Seat 9: cowbicha (small blind) showed [Ad Tc] and won (10776) with two pair, Aces and Tens



PokerStars Hand #189312511369: Tournament #2369778109, $0.23+$0.02 USD Hold'em No Limit - Level VII (100/200) - 2018/07/29 21:20:13 ET
Table '2369778109 3' 9-max Seat #9 is the button
Seat 1: MegadethChug (2803 in chips) 
Seat 2: rtrombin22 (6315 in chips) 
Seat 3: 89.N.M.W.06 (2094 in chips) 
Seat 4: flagao (6685 in chips) 
Seat 5: jamaralnt (6586 in chips) 
Seat 6: amand272 (2861 in chips) 
Seat 8: RodrigoCrvll (2244 in chips) 
Seat 9: cowbicha (10776 in chips) 
MegadethChug: posts the ante 25
rtrombin22: posts the ante 25
89.N.M.W.06: posts the ante 25
flagao: posts the ante 25
jamaralnt: posts the ante 25
amand272: posts the ante 25
RodrigoCrvll: posts the ante 25
cowbicha: posts the ante 25
MegadethChug: posts small blind 100
rtrombin22: posts big blind 200
*** HOLE CARDS ***
Dealt to flagao [5d Qd]
89.N.M.W.06: raises 1869 to 2069 and is all-in
flagao: folds 
jamaralnt: calls 2069
amand272: folds 
RodrigoCrvll: folds 
cowbicha: calls 2069
MegadethChug: folds 
rtrombin22: folds 
*** FLOP *** [Kd 2h Ts]
jamaralnt: bets 1200
cowbicha: folds 
Uncalled bet (1200) returned to jamaralnt
*** TURN *** [Kd 2h Ts] [Td]
*** RIVER *** [Kd 2h Ts Td] [8s]
*** SHOW DOWN ***
89.N.M.W.06: shows [4c 7s] (a pair of Tens)
jamaralnt: shows [Qs Ad] (a pair of Tens - Ace kicker)
jamaralnt collected 6707 from pot
89.N.M.W.06 finished the tournament in 16th place
*** SUMMARY ***
Total pot 6707 | Rake 0 
Board [Kd 2h Ts Td 8s]
Seat 1: MegadethChug (small blind) folded before Flop
Seat 2: rtrombin22 (big blind) folded before Flop
Seat 3: 89.N.M.W.06 showed [4c 7s] and lost with a pair of Tens
Seat 4: flagao folded before Flop (didn't bet)
Seat 5: jamaralnt showed [Qs Ad] and won (6707) with a pair of Tens
Seat 6: amand272 folded before Flop (didn't bet)
Seat 8: RodrigoCrvll folded before Flop (didn't bet)
Seat 9: cowbicha (button) folded on the Flop



PokerStars Hand #189312524453: Tournament #2369778109, $0.23+$0.02 USD Hold'em No Limit - Level VII (100/200) - 2018/07/29 21:20:50 ET
Table '2369778109 3' 9-max Seat #1 is the button
Seat 1: MegadethChug (2678 in chips) 
Seat 2: rtrombin22 (6090 in chips) 
Seat 4: flagao (6660 in chips) 
Seat 5: jamaralnt (11199 in chips) 
Seat 6: amand272 (2836 in chips) 
Seat 8: RodrigoCrvll (2219 in chips) 
Seat 9: cowbicha (8682 in chips) 
MegadethChug: posts the ante 25
rtrombin22: posts the ante 25
flagao: posts the ante 25
jamaralnt: posts the ante 25
amand272: posts the ante 25
RodrigoCrvll: posts the ante 25
cowbicha: posts the ante 25
rtrombin22: posts small blind 100
flagao: posts big blind 200
*** HOLE CARDS ***
Dealt to flagao [Qd 4h]
jamaralnt: raises 200 to 400
amand272: folds 
RodrigoCrvll: folds 
cowbicha: folds 
MegadethChug: folds 
rtrombin22: raises 5665 to 6065 and is all-in
flagao: folds 
jamaralnt: folds 
Uncalled bet (5665) returned to rtrombin22
rtrombin22 collected 1175 from pot
rtrombin22: doesn't show hand 
*** SUMMARY ***
Total pot 1175 | Rake 0 
Seat 1: MegadethChug (button) folded before Flop (didn't bet)
Seat 2: rtrombin22 (small blind) collected (1175)
Seat 4: flagao (big blind) folded before Flop
Seat 5: jamaralnt folded before Flop
Seat 6: amand272 folded before Flop (didn't bet)
Seat 8: RodrigoCrvll folded before Flop (didn't bet)
Seat 9: cowbicha folded before Flop (didn't bet)



PokerStars Hand #189312535499: Tournament #2369778109, $0.23+$0.02 USD Hold'em No Limit - Level VII (100/200) - 2018/07/29 21:21:21 ET
Table '2369778109 3' 9-max Seat #2 is the button
Seat 1: MegadethChug (2653 in chips) 
Seat 2: rtrombin22 (6840 in chips) 
Seat 4: flagao (6435 in chips) 
Seat 5: jamaralnt (10774 in chips) 
Seat 6: amand272 (2811 in chips) 
Seat 8: RodrigoCrvll (2194 in chips) 
Seat 9: cowbicha (8657 in chips) 
MegadethChug: posts the ante 25
rtrombin22: posts the ante 25
flagao: posts the ante 25
jamaralnt: posts the ante 25
amand272: posts the ante 25
RodrigoCrvll: posts the ante 25
cowbicha: posts the ante 25
flagao: posts small blind 100
jamaralnt: posts big blind 200
*** HOLE CARDS ***
Dealt to flagao [6d 9s]
amand272: folds 
RodrigoCrvll: folds 
cowbicha: folds 
MegadethChug: folds 
rtrombin22: folds 
flagao: folds 
Uncalled bet (100) returned to jamaralnt
jamaralnt collected 375 from pot
jamaralnt: doesn't show hand 
*** SUMMARY ***
Total pot 375 | Rake 0 
Seat 1: MegadethChug folded before Flop (didn't bet)
Seat 2: rtrombin22 (button) folded before Flop (didn't bet)
Seat 4: flagao (small blind) folded before Flop
Seat 5: jamaralnt (big blind) collected (375)
Seat 6: amand272 folded before Flop (didn't bet)
Seat 8: RodrigoCrvll folded before Flop (didn't bet)
Seat 9: cowbicha folded before Flop (didn't bet)



PokerStars Hand #189312543648: Tournament #2369778109, $0.23+$0.02 USD Hold'em No Limit - Level VII (100/200) - 2018/07/29 21:21:44 ET
Table '2369778109 3' 9-max Seat #4 is the button
Seat 1: MegadethChug (2628 in chips) 
Seat 2: rtrombin22 (6815 in chips) 
Seat 4: flagao (6310 in chips) 
Seat 5: jamaralnt (11024 in chips) 
Seat 6: amand272 (2786 in chips) 
Seat 8: RodrigoCrvll (2169 in chips) 
Seat 9: cowbicha (8632 in chips) 
MegadethChug: posts the ante 25
rtrombin22: posts the ante 25
flagao: posts the ante 25
jamaralnt: posts the ante 25
amand272: posts the ante 25
RodrigoCrvll: posts the ante 25
cowbicha: posts the ante 25
jamaralnt: posts small blind 100
amand272: posts big blind 200
*** HOLE CARDS ***
Dealt to flagao [Qs 7d]
RodrigoCrvll: folds 
cowbicha: folds 
MegadethChug: folds 
rtrombin22: folds 
flagao: folds 
jamaralnt: raises 200 to 400
amand272: folds 
Uncalled bet (200) returned to jamaralnt
jamaralnt collected 575 from pot
jamaralnt: doesn't show hand 
*** SUMMARY ***
Total pot 575 | Rake 0 
Seat 1: MegadethChug folded before Flop (didn't bet)
Seat 2: rtrombin22 folded before Flop (didn't bet)
Seat 4: flagao (button) folded before Flop (didn't bet)
Seat 5: jamaralnt (small blind) collected (575)
Seat 6: amand272 (big blind) folded before Flop
Seat 8: RodrigoCrvll folded before Flop (didn't bet)
Seat 9: cowbicha folded before Flop (didn't bet)



PokerStars Hand #189312553536: Tournament #2369778109, $0.23+$0.02 USD Hold'em No Limit - Level VII (100/200) - 2018/07/29 21:22:12 ET
Table '2369778109 3' 9-max Seat #5 is the button
Seat 1: MegadethChug (2603 in chips) 
Seat 2: rtrombin22 (6790 in chips) 
Seat 4: flagao (6285 in chips) 
Seat 5: jamaralnt (11374 in chips) 
Seat 6: amand272 (2561 in chips) 
Seat 8: RodrigoCrvll (2144 in chips) 
Seat 9: cowbicha (8607 in chips) 
MegadethChug: posts the ante 25
rtrombin22: posts the ante 25
flagao: posts the ante 25
jamaralnt: posts the ante 25
amand272: posts the ante 25
RodrigoCrvll: posts the ante 25
cowbicha: posts the ante 25
amand272: posts small blind 100
RodrigoCrvll: posts big blind 200
*** HOLE CARDS ***
Dealt to flagao [Ad 9d]
cowbicha: folds 
MegadethChug: folds 
rtrombin22: folds 
flagao: raises 300 to 500
jamaralnt: folds 
amand272: folds 
RodrigoCrvll: calls 300
*** FLOP *** [Js Ac 4c]
RodrigoCrvll: checks 
flagao: bets 800
RodrigoCrvll: folds 
Uncalled bet (800) returned to flagao
flagao collected 1275 from pot
flagao: doesn't show hand 
*** SUMMARY ***
Total pot 1275 | Rake 0 
Board [Js Ac 4c]
Seat 1: MegadethChug folded before Flop (didn't bet)
Seat 2: rtrombin22 folded before Flop (didn't bet)
Seat 4: flagao collected (1275)
Seat 5: jamaralnt (button) folded before Flop (didn't bet)
Seat 6: amand272 (small blind) folded before Flop
Seat 8: RodrigoCrvll (big blind) folded on the Flop
Seat 9: cowbicha folded before Flop (didn't bet)



PokerStars Hand #189312579834: Tournament #2369778109, $0.23+$0.02 USD Hold'em No Limit - Level VII (100/200) - 2018/07/29 21:23:27 ET
Table '2369778109 3' 9-max Seat #6 is the button
Seat 1: MegadethChug (2578 in chips) 
Seat 2: rtrombin22 (6765 in chips) 
Seat 4: flagao (7035 in chips) 
Seat 5: jamaralnt (11349 in chips) 
Seat 6: amand272 (2436 in chips) 
Seat 8: RodrigoCrvll (1619 in chips) 
Seat 9: cowbicha (8582 in chips) 
MegadethChug: posts the ante 25
rtrombin22: posts the ante 25
flagao: posts the ante 25
jamaralnt: posts the ante 25
amand272: posts the ante 25
RodrigoCrvll: posts the ante 25
cowbicha: posts the ante 25
RodrigoCrvll: posts small blind 100
cowbicha: posts big blind 200
*** HOLE CARDS ***
Dealt to flagao [Tc Qc]
MegadethChug: folds 
rtrombin22: raises 240 to 440
flagao: folds 
jamaralnt: folds 
amand272: folds 
RodrigoCrvll: folds 
cowbicha: folds 
Uncalled bet (240) returned to rtrombin22
rtrombin22 collected 675 from pot
rtrombin22: doesn't show hand 
*** SUMMARY ***
Total pot 675 | Rake 0 
Seat 1: MegadethChug folded before Flop (didn't bet)
Seat 2: rtrombin22 collected (675)
Seat 4: flagao folded before Flop (didn't bet)
Seat 5: jamaralnt folded before Flop (didn't bet)
Seat 6: amand272 (button) folded before Flop (didn't bet)
Seat 8: RodrigoCrvll (small blind) folded before Flop
Seat 9: cowbicha (big blind) folded before Flop



PokerStars Hand #189312588818: Tournament #2369778109, $0.23+$0.02 USD Hold'em No Limit - Level VII (100/200) - 2018/07/29 21:23:53 ET
Table '2369778109 3' 9-max Seat #8 is the button
Seat 1: MegadethChug (2553 in chips) 
Seat 2: rtrombin22 (7215 in chips) 
Seat 4: flagao (7010 in chips) 
Seat 5: jamaralnt (11324 in chips) 
Seat 6: amand272 (2411 in chips) 
Seat 8: RodrigoCrvll (1494 in chips) 
Seat 9: cowbicha (8357 in chips) 
MegadethChug: posts the ante 25
rtrombin22: posts the ante 25
flagao: posts the ante 25
jamaralnt: posts the ante 25
amand272: posts the ante 25
RodrigoCrvll: posts the ante 25
cowbicha: posts the ante 25
cowbicha: posts small blind 100
MegadethChug: posts big blind 200
*** HOLE CARDS ***
Dealt to flagao [3h 3c]
rtrombin22: folds 
flagao: raises 200 to 400
jamaralnt: raises 400 to 800
amand272: folds 
RodrigoCrvll: folds 
cowbicha: folds 
MegadethChug: folds 
flagao: folds 
Uncalled bet (400) returned to jamaralnt
jamaralnt collected 1275 from pot
jamaralnt: doesn't show hand 
*** SUMMARY ***
Total pot 1275 | Rake 0 
Seat 1: MegadethChug (big blind) folded before Flop
Seat 2: rtrombin22 folded before Flop (didn't bet)
Seat 4: flagao folded before Flop
Seat 5: jamaralnt collected (1275)
Seat 6: amand272 folded before Flop (didn't bet)
Seat 8: RodrigoCrvll (button) folded before Flop (didn't bet)
Seat 9: cowbicha (small blind) folded before Flop



PokerStars Hand #189312606638: Tournament #2369778109, $0.23+$0.02 USD Hold'em No Limit - Level VII (100/200) - 2018/07/29 21:24:44 ET
Table '2369778109 3' 9-max Seat #9 is the button
Seat 1: MegadethChug (2328 in chips) 
Seat 2: rtrombin22 (7190 in chips) 
Seat 4: flagao (6585 in chips) 
Seat 5: jamaralnt (12174 in chips) 
Seat 6: amand272 (2386 in chips) 
Seat 8: RodrigoCrvll (1469 in chips) 
Seat 9: cowbicha (8232 in chips) 
MegadethChug: posts the ante 25
rtrombin22: posts the ante 25
flagao: posts the ante 25
jamaralnt: posts the ante 25
amand272: posts the ante 25
RodrigoCrvll: posts the ante 25
cowbicha: posts the ante 25
MegadethChug: posts small blind 100
rtrombin22: posts big blind 200
*** HOLE CARDS ***
Dealt to flagao [Jc 5c]
flagao: folds 
jamaralnt: folds 
amand272: raises 400 to 600
RodrigoCrvll: folds 
cowbicha: raises 7607 to 8207 and is all-in
MegadethChug: calls 2203 and is all-in
rtrombin22: folds 
amand272: folds 
Uncalled bet (5904) returned to cowbicha
*** FLOP *** [8h 3s 7d]
*** TURN *** [8h 3s 7d] [2d]
*** RIVER *** [8h 3s 7d 2d] [Th]
*** SHOW DOWN ***
MegadethChug: shows [Td Ac] (a pair of Tens)
cowbicha: shows [Ah Qd] (high card Ace)
MegadethChug collected 5581 from pot
*** SUMMARY ***
Total pot 5581 | Rake 0 
Board [8h 3s 7d 2d Th]
Seat 1: MegadethChug (small blind) showed [Td Ac] and won (5581) with a pair of Tens
Seat 2: rtrombin22 (big blind) folded before Flop
Seat 4: flagao folded before Flop (didn't bet)
Seat 5: jamaralnt folded before Flop (didn't bet)
Seat 6: amand272 folded before Flop
Seat 8: RodrigoCrvll folded before Flop (didn't bet)
Seat 9: cowbicha (button) showed [Ah Qd] and lost with high card Ace



PokerStars Hand #189312621076: Tournament #2369778109, $0.23+$0.02 USD Hold'em No Limit - Level VII (100/200) - 2018/07/29 21:25:25 ET
Table '2369778109 3' 9-max Seat #1 is the button
Seat 1: MegadethChug (5581 in chips) 
Seat 2: rtrombin22 (6965 in chips) 
Seat 4: flagao (6560 in chips) 
Seat 5: jamaralnt (12149 in chips) 
Seat 6: amand272 (1761 in chips) 
Seat 8: RodrigoCrvll (1444 in chips) 
Seat 9: cowbicha (5904 in chips) 
MegadethChug: posts the ante 25
rtrombin22: posts the ante 25
flagao: posts the ante 25
jamaralnt: posts the ante 25
amand272: posts the ante 25
RodrigoCrvll: posts the ante 25
cowbicha: posts the ante 25
rtrombin22: posts small blind 100
flagao: posts big blind 200
*** HOLE CARDS ***
Dealt to flagao [Qs 9d]
jamaralnt: folds 
amand272: folds 
RodrigoCrvll: raises 200 to 400
cowbicha: folds 
MegadethChug: folds 
rtrombin22: folds 
flagao: calls 200
*** FLOP *** [8c Kc Qc]
flagao: checks 
RodrigoCrvll: bets 505
flagao: folds 
Uncalled bet (505) returned to RodrigoCrvll
RodrigoCrvll collected 1075 from pot
RodrigoCrvll: doesn't show hand 
*** SUMMARY ***
Total pot 1075 | Rake 0 
Board [8c Kc Qc]
Seat 1: MegadethChug (button) folded before Flop (didn't bet)
Seat 2: rtrombin22 (small blind) folded before Flop
Seat 4: flagao (big blind) folded on the Flop
Seat 5: jamaralnt folded before Flop (didn't bet)
Seat 6: amand272 folded before Flop (didn't bet)
Seat 8: RodrigoCrvll collected (1075)
Seat 9: cowbicha folded before Flop (didn't bet)



PokerStars Hand #189312633521: Tournament #2369778109, $0.23+$0.02 USD Hold'em No Limit - Level VII (100/200) - 2018/07/29 21:26:01 ET
Table '2369778109 3' 9-max Seat #2 is the button
Seat 1: MegadethChug (5556 in chips) 
Seat 2: rtrombin22 (6840 in chips) 
Seat 4: flagao (6135 in chips) 
Seat 5: jamaralnt (12124 in chips) 
Seat 6: amand272 (1736 in chips) 
Seat 8: RodrigoCrvll (2094 in chips) 
Seat 9: cowbicha (5879 in chips) 
MegadethChug: posts the ante 25
rtrombin22: posts the ante 25
flagao: posts the ante 25
jamaralnt: posts the ante 25
amand272: posts the ante 25
RodrigoCrvll: posts the ante 25
cowbicha: posts the ante 25
flagao: posts small blind 100
jamaralnt: posts big blind 200
*** HOLE CARDS ***
Dealt to flagao [8d 2d]
amand272: raises 1511 to 1711 and is all-in
RodrigoCrvll: folds 
cowbicha: folds 
MegadethChug: folds 
rtrombin22: folds 
flagao: folds 
jamaralnt: folds 
Uncalled bet (1511) returned to amand272
amand272 collected 675 from pot
*** SUMMARY ***
Total pot 675 | Rake 0 
Seat 1: MegadethChug folded before Flop (didn't bet)
Seat 2: rtrombin22 (button) folded before Flop (didn't bet)
Seat 4: flagao (small blind) folded before Flop
Seat 5: jamaralnt (big blind) folded before Flop
Seat 6: amand272 collected (675)
Seat 8: RodrigoCrvll folded before Flop (didn't bet)
Seat 9: cowbicha folded before Flop (didn't bet)



PokerStars Hand #189312641721: Tournament #2369778109, $0.23+$0.02 USD Hold'em No Limit - Level VII (100/200) - 2018/07/29 21:26:24 ET
Table '2369778109 3' 9-max Seat #4 is the button
Seat 1: MegadethChug (5531 in chips) 
Seat 2: rtrombin22 (6815 in chips) 
Seat 4: flagao (6010 in chips) 
Seat 5: jamaralnt (11899 in chips) 
Seat 6: amand272 (2186 in chips) 
Seat 8: RodrigoCrvll (2069 in chips) 
Seat 9: cowbicha (5854 in chips) 
MegadethChug: posts the ante 25
rtrombin22: posts the ante 25
flagao: posts the ante 25
jamaralnt: posts the ante 25
amand272: posts the ante 25
RodrigoCrvll: posts the ante 25
cowbicha: posts the ante 25
jamaralnt: posts small blind 100
amand272: posts big blind 200
*** HOLE CARDS ***
Dealt to flagao [3s 8h]
RodrigoCrvll: folds 
cowbicha: folds 
MegadethChug: folds 
rtrombin22: folds 
flagao: folds 
jamaralnt: raises 200 to 400
amand272: calls 200
*** FLOP *** [5c 6s Ac]
jamaralnt: bets 400
amand272: folds 
Uncalled bet (400) returned to jamaralnt
jamaralnt collected 975 from pot
jamaralnt: doesn't show hand 
*** SUMMARY ***
Total pot 975 | Rake 0 
Board [5c 6s Ac]
Seat 1: MegadethChug folded before Flop (didn't bet)
Seat 2: rtrombin22 folded before Flop (didn't bet)
Seat 4: flagao (button) folded before Flop (didn't bet)
Seat 5: jamaralnt (small blind) collected (975)
Seat 6: amand272 (big blind) folded on the Flop
Seat 8: RodrigoCrvll folded before Flop (didn't bet)
Seat 9: cowbicha folded before Flop (didn't bet)



PokerStars Hand #189312654611: Tournament #2369778109, $0.23+$0.02 USD Hold'em No Limit - Level VII (100/200) - 2018/07/29 21:27:01 ET
Table '2369778109 3' 9-max Seat #5 is the button
Seat 1: MegadethChug (5506 in chips) 
Seat 2: rtrombin22 (6790 in chips) 
Seat 4: flagao (5985 in chips) 
Seat 5: jamaralnt (12449 in chips) 
Seat 6: amand272 (1761 in chips) 
Seat 8: RodrigoCrvll (2044 in chips) 
Seat 9: cowbicha (5829 in chips) 
MegadethChug: posts the ante 25
rtrombin22: posts the ante 25
flagao: posts the ante 25
jamaralnt: posts the ante 25
amand272: posts the ante 25
RodrigoCrvll: posts the ante 25
cowbicha: posts the ante 25
amand272: posts small blind 100
RodrigoCrvll: posts big blind 200
*** HOLE CARDS ***
Dealt to flagao [Tc 4s]
cowbicha: folds 
MegadethChug: folds 
rtrombin22: folds 
flagao: folds 
jamaralnt: folds 
amand272: calls 100
RodrigoCrvll: checks 
*** FLOP *** [2c 3s 4d]
amand272: bets 200
RodrigoCrvll: folds 
Uncalled bet (200) returned to amand272
amand272 collected 575 from pot
*** SUMMARY ***
Total pot 575 | Rake 0 
Board [2c 3s 4d]
Seat 1: MegadethChug folded before Flop (didn't bet)
Seat 2: rtrombin22 folded before Flop (didn't bet)
Seat 4: flagao folded before Flop (didn't bet)
Seat 5: jamaralnt (button) folded before Flop (didn't bet)
Seat 6: amand272 (small blind) collected (575)
Seat 8: RodrigoCrvll (big blind) folded on the Flop
Seat 9: cowbicha folded before Flop (didn't bet)



PokerStars Hand #189312667143: Tournament #2369778109, $0.23+$0.02 USD Hold'em No Limit - Level VIII (150/300) - 2018/07/29 21:27:37 ET
Table '2369778109 3' 9-max Seat #6 is the button
Seat 1: MegadethChug (5481 in chips) 
Seat 2: rtrombin22 (6765 in chips) 
Seat 4: flagao (5960 in chips) 
Seat 5: jamaralnt (12424 in chips) 
Seat 6: amand272 (2111 in chips) 
Seat 8: RodrigoCrvll (1819 in chips) 
Seat 9: cowbicha (5804 in chips) 
MegadethChug: posts the ante 25
rtrombin22: posts the ante 25
flagao: posts the ante 25
jamaralnt: posts the ante 25
amand272: posts the ante 25
RodrigoCrvll: posts the ante 25
cowbicha: posts the ante 25
RodrigoCrvll: posts small blind 150
cowbicha: posts big blind 300
*** HOLE CARDS ***
Dealt to flagao [Ks 9c]
MegadethChug: folds 
rtrombin22: folds 
flagao: folds 
jamaralnt: folds 
amand272: folds 
RodrigoCrvll: folds 
Uncalled bet (150) returned to cowbicha
cowbicha collected 475 from pot
*** SUMMARY ***
Total pot 475 | Rake 0 
Seat 1: MegadethChug folded before Flop (didn't bet)
Seat 2: rtrombin22 folded before Flop (didn't bet)
Seat 4: flagao folded before Flop (didn't bet)
Seat 5: jamaralnt folded before Flop (didn't bet)
Seat 6: amand272 (button) folded before Flop (didn't bet)
Seat 8: RodrigoCrvll (small blind) folded before Flop
Seat 9: cowbicha (big blind) collected (475)



PokerStars Hand #189312674942: Tournament #2369778109, $0.23+$0.02 USD Hold'em No Limit - Level VIII (150/300) - 2018/07/29 21:27:59 ET
Table '2369778109 3' 9-max Seat #8 is the button
Seat 1: MegadethChug (5456 in chips) 
Seat 2: rtrombin22 (6740 in chips) 
Seat 4: flagao (5935 in chips) 
Seat 5: jamaralnt (12399 in chips) 
Seat 6: amand272 (2086 in chips) 
Seat 8: RodrigoCrvll (1644 in chips) 
Seat 9: cowbicha (6104 in chips) 
MegadethChug: posts the ante 25
rtrombin22: posts the ante 25
flagao: posts the ante 25
jamaralnt: posts the ante 25
amand272: posts the ante 25
RodrigoCrvll: posts the ante 25
cowbicha: posts the ante 25
cowbicha: posts small blind 150
MegadethChug: posts big blind 300
*** HOLE CARDS ***
Dealt to flagao [4c 9s]
rtrombin22: folds 
flagao: folds 
jamaralnt: folds 
amand272: folds 
RodrigoCrvll: folds 
cowbicha: folds 
Uncalled bet (150) returned to MegadethChug
MegadethChug collected 475 from pot
*** SUMMARY ***
Total pot 475 | Rake 0 
Seat 1: MegadethChug (big blind) collected (475)
Seat 2: rtrombin22 folded before Flop (didn't bet)
Seat 4: flagao folded before Flop (didn't bet)
Seat 5: jamaralnt folded before Flop (didn't bet)
Seat 6: amand272 folded before Flop (didn't bet)
Seat 8: RodrigoCrvll (button) folded before Flop (didn't bet)
Seat 9: cowbicha (small blind) folded before Flop



PokerStars Hand #189312683508: Tournament #2369778109, $0.23+$0.02 USD Hold'em No Limit - Level VIII (150/300) - 2018/07/29 21:28:23 ET
Table '2369778109 3' 9-max Seat #9 is the button
Seat 1: MegadethChug (5756 in chips) 
Seat 2: rtrombin22 (6715 in chips) 
Seat 4: flagao (5910 in chips) 
Seat 5: jamaralnt (12374 in chips) 
Seat 6: amand272 (2061 in chips) 
Seat 8: RodrigoCrvll (1619 in chips) 
Seat 9: cowbicha (5929 in chips) 
MegadethChug: posts the ante 25
rtrombin22: posts the ante 25
flagao: posts the ante 25
jamaralnt: posts the ante 25
amand272: posts the ante 25
RodrigoCrvll: posts the ante 25
cowbicha: posts the ante 25
MegadethChug: posts small blind 150
rtrombin22: posts big blind 300
*** HOLE CARDS ***
Dealt to flagao [7s 8c]
flagao: folds 
jamaralnt: folds 
amand272: folds 
RodrigoCrvll: folds 
cowbicha: raises 300 to 600
MegadethChug: folds 
rtrombin22: calls 300
*** FLOP *** [Qd 5d 9s]
rtrombin22: checks 
cowbicha: bets 763
rtrombin22: calls 763
*** TURN *** [Qd 5d 9s] [Ah]
rtrombin22: checks 
cowbicha: bets 1526
rtrombin22: folds 
Uncalled bet (1526) returned to cowbicha
cowbicha collected 3051 from pot
*** SUMMARY ***
Total pot 3051 | Rake 0 
Board [Qd 5d 9s Ah]
Seat 1: MegadethChug (small blind) folded before Flop
Seat 2: rtrombin22 (big blind) folded on the Turn
Seat 4: flagao folded before Flop (didn't bet)
Seat 5: jamaralnt folded before Flop (didn't bet)
Seat 6: amand272 folded before Flop (didn't bet)
Seat 8: RodrigoCrvll folded before Flop (didn't bet)
Seat 9: cowbicha (button) collected (3051)



PokerStars Hand #189312701424: Tournament #2369778109, $0.23+$0.02 USD Hold'em No Limit - Level VIII (150/300) - 2018/07/29 21:29:15 ET
Table '2369778109 3' 9-max Seat #1 is the button
Seat 1: MegadethChug (5581 in chips) 
Seat 2: rtrombin22 (5327 in chips) 
Seat 4: flagao (5885 in chips) 
Seat 5: jamaralnt (12349 in chips) 
Seat 6: amand272 (2036 in chips) 
Seat 8: RodrigoCrvll (1594 in chips) 
Seat 9: cowbicha (7592 in chips) 
MegadethChug: posts the ante 25
rtrombin22: posts the ante 25
flagao: posts the ante 25
jamaralnt: posts the ante 25
amand272: posts the ante 25
RodrigoCrvll: posts the ante 25
cowbicha: posts the ante 25
rtrombin22: posts small blind 150
flagao: posts big blind 300
*** HOLE CARDS ***
Dealt to flagao [9d 8c]
jamaralnt: raises 300 to 600
amand272: folds 
RodrigoCrvll: folds 
cowbicha: folds 
MegadethChug: folds 
rtrombin22: folds 
flagao: folds 
Uncalled bet (300) returned to jamaralnt
jamaralnt collected 925 from pot
jamaralnt: doesn't show hand 
*** SUMMARY ***
Total pot 925 | Rake 0 
Seat 1: MegadethChug (button) folded before Flop (didn't bet)
Seat 2: rtrombin22 (small blind) folded before Flop
Seat 4: flagao (big blind) folded before Flop
Seat 5: jamaralnt collected (925)
Seat 6: amand272 folded before Flop (didn't bet)
Seat 8: RodrigoCrvll folded before Flop (didn't bet)
Seat 9: cowbicha folded before Flop (didn't bet)



PokerStars Hand #189312708262: Tournament #2369778109, $0.23+$0.02 USD Hold'em No Limit - Level VIII (150/300) - 2018/07/29 21:29:34 ET
Table '2369778109 3' 9-max Seat #2 is the button
Seat 1: MegadethChug (5556 in chips) 
Seat 2: rtrombin22 (5152 in chips) 
Seat 4: flagao (5560 in chips) 
Seat 5: jamaralnt (12949 in chips) 
Seat 6: amand272 (2011 in chips) 
Seat 8: RodrigoCrvll (1569 in chips) 
Seat 9: cowbicha (7567 in chips) 
MegadethChug: posts the ante 25
rtrombin22: posts the ante 25
flagao: posts the ante 25
jamaralnt: posts the ante 25
amand272: posts the ante 25
RodrigoCrvll: posts the ante 25
cowbicha: posts the ante 25
flagao: posts small blind 150
jamaralnt: posts big blind 300
*** HOLE CARDS ***
Dealt to flagao [Js As]
amand272: calls 300
RodrigoCrvll: folds 
cowbicha: folds 
MegadethChug: folds 
rtrombin22: calls 300
flagao: raises 600 to 900
jamaralnt: folds 
amand272: calls 600
rtrombin22: folds 
*** FLOP *** [5h Kh 7h]
flagao: bets 1200
amand272: calls 1086 and is all-in
Uncalled bet (114) returned to flagao
*** TURN *** [5h Kh 7h] [8s]
*** RIVER *** [5h Kh 7h 8s] [4c]
*** SHOW DOWN ***
flagao: shows [Js As] (high card Ace)
amand272: shows [Ah Ts] (high card Ace - lower kicker)
flagao collected 4747 from pot
amand272 finished the tournament in 13th place
*** SUMMARY ***
Total pot 4747 | Rake 0 
Board [5h Kh 7h 8s 4c]
Seat 1: MegadethChug folded before Flop (didn't bet)
Seat 2: rtrombin22 (button) folded before Flop
Seat 4: flagao (small blind) showed [Js As] and won (4747) with high card Ace
Seat 5: jamaralnt (big blind) folded before Flop
Seat 6: amand272 showed [Ah Ts] and lost with high card Ace
Seat 8: RodrigoCrvll folded before Flop (didn't bet)
Seat 9: cowbicha folded before Flop (didn't bet)



PokerStars Hand #189312725495: Tournament #2369778109, $0.23+$0.02 USD Hold'em No Limit - Level VIII (150/300) - 2018/07/29 21:30:23 ET
Table '2369778109 3' 9-max Seat #4 is the button
Seat 1: MegadethChug (5531 in chips) 
Seat 2: rtrombin22 (4827 in chips) 
Seat 4: flagao (8296 in chips) 
Seat 5: jamaralnt (12624 in chips) 
Seat 8: RodrigoCrvll (1544 in chips) 
Seat 9: cowbicha (7542 in chips) 
MegadethChug: posts the ante 25
rtrombin22: posts the ante 25
flagao: posts the ante 25
jamaralnt: posts the ante 25
RodrigoCrvll: posts the ante 25
cowbicha: posts the ante 25
jamaralnt: posts small blind 150
RodrigoCrvll: posts big blind 300
*** HOLE CARDS ***
Dealt to flagao [Jd 5c]
cowbicha: folds 
MegadethChug: raises 300 to 600
rtrombin22: folds 
flagao: folds 
jamaralnt: folds 
RodrigoCrvll: folds 
Uncalled bet (300) returned to MegadethChug
MegadethChug collected 900 from pot
*** SUMMARY ***
Total pot 900 | Rake 0 
Seat 1: MegadethChug collected (900)
Seat 2: rtrombin22 folded before Flop (didn't bet)
Seat 4: flagao (button) folded before Flop (didn't bet)
Seat 5: jamaralnt (small blind) folded before Flop
Seat 8: RodrigoCrvll (big blind) folded before Flop
Seat 9: cowbicha folded before Flop (didn't bet)



PokerStars Hand #189312737554: Tournament #2369778109, $0.23+$0.02 USD Hold'em No Limit - Level VIII (150/300) - 2018/07/29 21:30:46 ET
Table '2369778109 3' 9-max Seat #5 is the button
Seat 1: MegadethChug (6106 in chips) 
Seat 2: rtrombin22 (4802 in chips) 
Seat 4: flagao (8271 in chips) 
Seat 5: jamaralnt (12449 in chips) 
Seat 8: RodrigoCrvll (1219 in chips) 
Seat 9: cowbicha (7517 in chips) 
MegadethChug: posts the ante 25
rtrombin22: posts the ante 25
flagao: posts the ante 25
jamaralnt: posts the ante 25
RodrigoCrvll: posts the ante 25
cowbicha: posts the ante 25
RodrigoCrvll: posts small blind 150
cowbicha: posts big blind 300
*** HOLE CARDS ***
Dealt to flagao [2h 5s]
MegadethChug: folds 
rtrombin22: raises 360 to 660
flagao: folds 
jamaralnt: raises 360 to 1020
RodrigoCrvll: calls 870
cowbicha: folds 
rtrombin22: calls 360
*** FLOP *** [7c 4d Kh]
RodrigoCrvll: bets 174 and is all-in
rtrombin22: calls 174
jamaralnt: raises 1026 to 1200
rtrombin22: folds 
Uncalled bet (1026) returned to jamaralnt
*** TURN *** [7c 4d Kh] [3s]
*** RIVER *** [7c 4d Kh 3s] [Qd]
*** SHOW DOWN ***
RodrigoCrvll: shows [Ac Tc] (high card Ace)
jamaralnt: shows [Kc Jc] (a pair of Kings)
jamaralnt collected 4032 from pot
RodrigoCrvll finished the tournament in 12th place
*** SUMMARY ***
Total pot 4032 | Rake 0 
Board [7c 4d Kh 3s Qd]
Seat 1: MegadethChug folded before Flop (didn't bet)
Seat 2: rtrombin22 folded on the Flop
Seat 4: flagao folded before Flop (didn't bet)
Seat 5: jamaralnt (button) showed [Kc Jc] and won (4032) with a pair of Kings
Seat 8: RodrigoCrvll (small blind) showed [Ac Tc] and lost with high card Ace
Seat 9: cowbicha (big blind) folded before Flop



PokerStars Hand #189312760018: Tournament #2369778109, $0.23+$0.02 USD Hold'em No Limit - Level VIII (150/300) - 2018/07/29 21:31:52 ET
Table '2369778109 3' 9-max Seat #9 is the button
Seat 1: MegadethChug (6081 in chips) 
Seat 2: rtrombin22 (3583 in chips) 
Seat 4: flagao (8246 in chips) 
Seat 5: jamaralnt (15262 in chips) 
Seat 9: cowbicha (7192 in chips) 
MegadethChug: posts the ante 25
rtrombin22: posts the ante 25
flagao: posts the ante 25
jamaralnt: posts the ante 25
cowbicha: posts the ante 25
MegadethChug: posts small blind 150
rtrombin22: posts big blind 300
*** HOLE CARDS ***
Dealt to flagao [5c 9h]
flagao: folds 
jamaralnt: folds 
cowbicha: raises 300 to 600
MegadethChug: folds 
rtrombin22: raises 2958 to 3558 and is all-in
cowbicha: folds [Qs]
Uncalled bet (2958) returned to rtrombin22
rtrombin22 collected 1475 from pot
rtrombin22: doesn't show hand 
*** SUMMARY ***
Total pot 1475 | Rake 0 
Seat 1: MegadethChug (small blind) folded before Flop
Seat 2: rtrombin22 (big blind) collected (1475)
Seat 4: flagao folded before Flop (didn't bet)
Seat 5: jamaralnt folded before Flop (didn't bet)
Seat 9: cowbicha (button) folded before Flop



PokerStars Hand #189312770036: Tournament #2369778109, $0.23+$0.02 USD Hold'em No Limit - Level VIII (150/300) - 2018/07/29 21:32:22 ET
Table '2369778109 3' 9-max Seat #1 is the button
Seat 1: MegadethChug (5906 in chips) 
Seat 2: rtrombin22 (4433 in chips) 
Seat 4: flagao (8221 in chips) 
Seat 5: jamaralnt (15237 in chips) 
Seat 9: cowbicha (6567 in chips) 
MegadethChug: posts the ante 25
rtrombin22: posts the ante 25
flagao: posts the ante 25
jamaralnt: posts the ante 25
cowbicha: posts the ante 25
rtrombin22: posts small blind 150
flagao: posts big blind 300
*** HOLE CARDS ***
Dealt to flagao [As Kc]
jamaralnt: raises 300 to 600
cowbicha: folds 
MegadethChug: folds 
rtrombin22: raises 3808 to 4408 and is all-in
flagao: folds 
jamaralnt: calls 3808
*** FLOP *** [5h 5s 3h]
*** TURN *** [5h 5s 3h] [Jc]
*** RIVER *** [5h 5s 3h Jc] [6d]
*** SHOW DOWN ***
rtrombin22: shows [Qs Qd] (two pair, Queens and Fives)
jamaralnt: shows [Ad Ac] (two pair, Aces and Fives)
jamaralnt collected 9241 from pot
rtrombin22 finished the tournament in 11th place
*** SUMMARY ***
Total pot 9241 | Rake 0 
Board [5h 5s 3h Jc 6d]
Seat 1: MegadethChug (button) folded before Flop (didn't bet)
Seat 2: rtrombin22 (small blind) showed [Qs Qd] and lost with two pair, Queens and Fives
Seat 4: flagao (big blind) folded before Flop
Seat 5: jamaralnt showed [Ad Ac] and won (9241) with two pair, Aces and Fives
Seat 9: cowbicha folded before Flop (didn't bet)



PokerStars Hand #189312783326: Tournament #2369778109, $0.23+$0.02 USD Hold'em No Limit - Level VIII (150/300) - 2018/07/29 21:33:01 ET
Table '2369778109 3' 9-max Seat #4 is the button
Seat 1: MegadethChug (5881 in chips) 
Seat 4: flagao (7896 in chips) 
Seat 5: jamaralnt (20045 in chips) 
Seat 9: cowbicha (6542 in chips) 
MegadethChug: posts the ante 25
flagao: posts the ante 25
jamaralnt: posts the ante 25
cowbicha: posts the ante 25
jamaralnt: posts small blind 150
cowbicha: posts big blind 300
*** HOLE CARDS ***
Dealt to flagao [2h 5s]
MegadethChug: calls 300
flagao: folds 
jamaralnt: calls 150
cowbicha: checks 
*** FLOP *** [Qd Qs 9d]
jamaralnt: checks 
cowbicha: checks 
MegadethChug: checks 
*** TURN *** [Qd Qs 9d] [Ah]
jamaralnt: checks 
cowbicha: checks 
MegadethChug: checks 
*** RIVER *** [Qd Qs 9d Ah] [Qc]
jamaralnt: checks 
cowbicha: checks 
MegadethChug: checks 
*** SHOW DOWN ***
jamaralnt: shows [Td Js] (three of a kind, Queens)
cowbicha: shows [Jc 6d] (three of a kind, Queens)
MegadethChug: mucks hand 
jamaralnt collected 500 from pot
cowbicha collected 500 from pot
*** SUMMARY ***
Total pot 1000 | Rake 0 
Board [Qd Qs 9d Ah Qc]
Seat 1: MegadethChug mucked [6c 7c]
Seat 4: flagao (button) folded before Flop (didn't bet)
Seat 5: jamaralnt (small blind) showed [Td Js] and won (500) with three of a kind, Queens
Seat 9: cowbicha (big blind) showed [Jc 6d] and won (500) with three of a kind, Queens



PokerStars Hand #189312795798: Tournament #2369778109, $0.23+$0.02 USD Hold'em No Limit - Level VIII (150/300) - 2018/07/29 21:33:38 ET
Table '2369778109 3' 9-max Seat #5 is the button
Seat 1: MegadethChug (5556 in chips) 
Seat 2: dioclecio13 (3815 in chips) 
Seat 3: Axxxidental (8913 in chips) 
Seat 4: flagao (7871 in chips) 
Seat 5: jamaralnt (20220 in chips) 
Seat 9: cowbicha (6717 in chips) 
MegadethChug: posts the ante 25
dioclecio13: posts the ante 25
Axxxidental: posts the ante 25
flagao: posts the ante 25
jamaralnt: posts the ante 25
cowbicha: posts the ante 25
cowbicha: posts small blind 150
MegadethChug: posts big blind 300
*** HOLE CARDS ***
Dealt to flagao [Ks 3c]
dioclecio13: folds 
Axxxidental: folds 
flagao: folds 
jamaralnt: raises 300 to 600
cowbicha: folds 
MegadethChug: calls 300
*** FLOP *** [5d 8c 3h]
MegadethChug: checks 
jamaralnt: bets 750
MegadethChug: folds 
Uncalled bet (750) returned to jamaralnt
jamaralnt collected 1500 from pot
jamaralnt: doesn't show hand 
*** SUMMARY ***
Total pot 1500 | Rake 0 
Board [5d 8c 3h]
Seat 1: MegadethChug (big blind) folded on the Flop
Seat 2: dioclecio13 folded before Flop (didn't bet)
Seat 3: Axxxidental folded before Flop (didn't bet)
Seat 4: flagao folded before Flop (didn't bet)
Seat 5: jamaralnt (button) collected (1500)
Seat 9: cowbicha (small blind) folded before Flop



PokerStars Hand #189312805171: Tournament #2369778109, $0.23+$0.02 USD Hold'em No Limit - Level VIII (150/300) - 2018/07/29 21:34:05 ET
Table '2369778109 3' 9-max Seat #9 is the button
Seat 1: MegadethChug (4931 in chips) 
Seat 2: dioclecio13 (3790 in chips) 
Seat 3: Axxxidental (8888 in chips) 
Seat 4: flagao (7846 in chips) 
Seat 5: jamaralnt (21095 in chips) 
Seat 6: wesley18sant (6727 in chips) 
Seat 7: alebitenco (6067 in chips) 
Seat 8: intelllect (1614 in chips) 
Seat 9: cowbicha (6542 in chips) 
MegadethChug: posts the ante 25
dioclecio13: posts the ante 25
Axxxidental: posts the ante 25
flagao: posts the ante 25
jamaralnt: posts the ante 25
wesley18sant: posts the ante 25
alebitenco: posts the ante 25
intelllect: posts the ante 25
cowbicha: posts the ante 25
MegadethChug: posts small blind 150
dioclecio13: posts big blind 300
*** HOLE CARDS ***
Dealt to flagao [3h 5h]
Axxxidental: folds 
flagao: folds 
jamaralnt: folds 
wesley18sant: folds 
alebitenco: folds 
intelllect: folds 
cowbicha: raises 300 to 600
MegadethChug: calls 450
dioclecio13: calls 300
*** FLOP *** [6c Js Qs]
MegadethChug: checks 
dioclecio13: checks 
cowbicha: bets 1013
MegadethChug: folds 
dioclecio13: folds 
Uncalled bet (1013) returned to cowbicha
cowbicha collected 2025 from pot
*** SUMMARY ***
Total pot 2025 | Rake 0 
Board [6c Js Qs]
Seat 1: MegadethChug (small blind) folded on the Flop
Seat 2: dioclecio13 (big blind) folded on the Flop
Seat 3: Axxxidental folded before Flop (didn't bet)
Seat 4: flagao folded before Flop (didn't bet)
Seat 5: jamaralnt folded before Flop (didn't bet)
Seat 6: wesley18sant folded before Flop (didn't bet)
Seat 7: alebitenco folded before Flop (didn't bet)
Seat 8: intelllect folded before Flop (didn't bet)
Seat 9: cowbicha (button) collected (2025)



PokerStars Hand #189312827647: Tournament #2369778109, $0.23+$0.02 USD Hold'em No Limit - Level VIII (150/300) - 2018/07/29 21:35:11 ET
Table '2369778109 3' 9-max Seat #1 is the button
Seat 1: MegadethChug (4306 in chips) 
Seat 2: dioclecio13 (3165 in chips) 
Seat 3: Axxxidental (8863 in chips) 
Seat 4: flagao (7821 in chips) 
Seat 5: jamaralnt (21070 in chips) 
Seat 6: wesley18sant (6702 in chips) 
Seat 7: alebitenco (6042 in chips) 
Seat 8: intelllect (1589 in chips) 
Seat 9: cowbicha (7942 in chips) 
MegadethChug: posts the ante 25
dioclecio13: posts the ante 25
Axxxidental: posts the ante 25
flagao: posts the ante 25
jamaralnt: posts the ante 25
wesley18sant: posts the ante 25
alebitenco: posts the ante 25
intelllect: posts the ante 25
cowbicha: posts the ante 25
dioclecio13: posts small blind 150
Axxxidental: posts big blind 300
*** HOLE CARDS ***
Dealt to flagao [Kd 7h]
flagao: folds 
jamaralnt: folds 
wesley18sant: raises 600 to 900
alebitenco: folds 
intelllect: folds 
cowbicha: folds 
MegadethChug: raises 3381 to 4281 and is all-in
dioclecio13: folds 
Axxxidental: folds 
wesley18sant: folds 
Uncalled bet (3381) returned to MegadethChug
MegadethChug collected 2475 from pot
*** SUMMARY ***
Total pot 2475 | Rake 0 
Seat 1: MegadethChug (button) collected (2475)
Seat 2: dioclecio13 (small blind) folded before Flop
Seat 3: Axxxidental (big blind) folded before Flop
Seat 4: flagao folded before Flop (didn't bet)
Seat 5: jamaralnt folded before Flop (didn't bet)
Seat 6: wesley18sant folded before Flop
Seat 7: alebitenco folded before Flop (didn't bet)
Seat 8: intelllect folded before Flop (didn't bet)
Seat 9: cowbicha folded before Flop (didn't bet)



PokerStars Hand #189312842776: Tournament #2369778109, $0.23+$0.02 USD Hold'em No Limit - Level VIII (150/300) - 2018/07/29 21:35:54 ET
Table '2369778109 3' 9-max Seat #2 is the button
Seat 1: MegadethChug (5856 in chips) 
Seat 2: dioclecio13 (2990 in chips) 
Seat 3: Axxxidental (8538 in chips) 
Seat 4: flagao (7796 in chips) 
Seat 5: jamaralnt (21045 in chips) 
Seat 6: wesley18sant (5777 in chips) 
Seat 7: alebitenco (6017 in chips) 
Seat 8: intelllect (1564 in chips) 
Seat 9: cowbicha (7917 in chips) 
MegadethChug: posts the ante 25
dioclecio13: posts the ante 25
Axxxidental: posts the ante 25
flagao: posts the ante 25
jamaralnt: posts the ante 25
wesley18sant: posts the ante 25
alebitenco: posts the ante 25
intelllect: posts the ante 25
cowbicha: posts the ante 25
Axxxidental: posts small blind 150
flagao: posts big blind 300
*** HOLE CARDS ***
Dealt to flagao [3c 3d]
jamaralnt: raises 300 to 600
wesley18sant: folds 
alebitenco: folds 
intelllect: folds 
cowbicha: folds 
MegadethChug: folds 
dioclecio13: folds 
Axxxidental: calls 450
flagao: calls 300
*** FLOP *** [Ad 5s 3s]
Axxxidental: checks 
flagao: bets 1200
jamaralnt: calls 1200
Axxxidental: folds 
*** TURN *** [Ad 5s 3s] [4s]
flagao: checks 
jamaralnt: bets 1328
flagao: raises 4643 to 5971 and is all-in
jamaralnt: calls 4643
*** RIVER *** [Ad 5s 3s 4s] [Qh]
*** SHOW DOWN ***
flagao: shows [3c 3d] (three of a kind, Threes)
jamaralnt: shows [Ac Th] (a pair of Aces)
flagao collected 16367 from pot
*** SUMMARY ***
Total pot 16367 | Rake 0 
Board [Ad 5s 3s 4s Qh]
Seat 1: MegadethChug folded before Flop (didn't bet)
Seat 2: dioclecio13 (button) folded before Flop (didn't bet)
Seat 3: Axxxidental (small blind) folded on the Flop
Seat 4: flagao (big blind) showed [3c 3d] and won (16367) with three of a kind, Threes
Seat 5: jamaralnt showed [Ac Th] and lost with a pair of Aces
Seat 6: wesley18sant folded before Flop (didn't bet)
Seat 7: alebitenco folded before Flop (didn't bet)
Seat 8: intelllect folded before Flop (didn't bet)
Seat 9: cowbicha folded before Flop (didn't bet)



PokerStars Hand #189312863653: Tournament #2369778109, $0.23+$0.02 USD Hold'em No Limit - Level VIII (150/300) - 2018/07/29 21:36:55 ET
Table '2369778109 3' 9-max Seat #3 is the button
Seat 1: MegadethChug (5831 in chips) 
Seat 2: dioclecio13 (2965 in chips) 
Seat 3: Axxxidental (7913 in chips) 
Seat 4: flagao (16367 in chips) 
Seat 5: jamaralnt (13249 in chips) 
Seat 6: wesley18sant (5752 in chips) 
Seat 7: alebitenco (5992 in chips) 
Seat 8: intelllect (1539 in chips) 
Seat 9: cowbicha (7892 in chips) 
MegadethChug: posts the ante 25
dioclecio13: posts the ante 25
Axxxidental: posts the ante 25
flagao: posts the ante 25
jamaralnt: posts the ante 25
wesley18sant: posts the ante 25
alebitenco: posts the ante 25
intelllect: posts the ante 25
cowbicha: posts the ante 25
flagao: posts small blind 150
jamaralnt: posts big blind 300
*** HOLE CARDS ***
Dealt to flagao [6h Ts]
wesley18sant: folds 
alebitenco: folds 
intelllect: folds 
cowbicha: folds 
MegadethChug: folds 
dioclecio13: folds 
Axxxidental: folds 
flagao: folds 
Uncalled bet (150) returned to jamaralnt
jamaralnt collected 525 from pot
jamaralnt: doesn't show hand 
*** SUMMARY ***
Total pot 525 | Rake 0 
Seat 1: MegadethChug folded before Flop (didn't bet)
Seat 2: dioclecio13 folded before Flop (didn't bet)
Seat 3: Axxxidental (button) folded before Flop (didn't bet)
Seat 4: flagao (small blind) folded before Flop
Seat 5: jamaralnt (big blind) collected (525)
Seat 6: wesley18sant folded before Flop (didn't bet)
Seat 7: alebitenco folded before Flop (didn't bet)
Seat 8: intelllect folded before Flop (didn't bet)
Seat 9: cowbicha folded before Flop (didn't bet)



PokerStars Hand #189312874402: Tournament #2369778109, $0.23+$0.02 USD Hold'em No Limit - Level IX (200/400) - 2018/07/29 21:37:26 ET
Table '2369778109 3' 9-max Seat #4 is the button
Seat 1: MegadethChug (5806 in chips) 
Seat 2: dioclecio13 (2940 in chips) 
Seat 3: Axxxidental (7888 in chips) 
Seat 4: flagao (16192 in chips) 
Seat 5: jamaralnt (13599 in chips) 
Seat 6: wesley18sant (5727 in chips) 
Seat 7: alebitenco (5967 in chips) 
Seat 8: intelllect (1514 in chips) 
Seat 9: cowbicha (7867 in chips) 
MegadethChug: posts the ante 25
dioclecio13: posts the ante 25
Axxxidental: posts the ante 25
flagao: posts the ante 25
jamaralnt: posts the ante 25
wesley18sant: posts the ante 25
alebitenco: posts the ante 25
intelllect: posts the ante 25
cowbicha: posts the ante 25
jamaralnt: posts small blind 200
wesley18sant: posts big blind 400
*** HOLE CARDS ***
Dealt to flagao [6d 4d]
alebitenco: folds 
intelllect: folds 
cowbicha: folds 
MegadethChug: folds 
dioclecio13: folds 
Axxxidental: folds 
flagao: folds 
jamaralnt: raises 400 to 800
wesley18sant: folds 
Uncalled bet (400) returned to jamaralnt
jamaralnt collected 1025 from pot
jamaralnt: doesn't show hand 
*** SUMMARY ***
Total pot 1025 | Rake 0 
Seat 1: MegadethChug folded before Flop (didn't bet)
Seat 2: dioclecio13 folded before Flop (didn't bet)
Seat 3: Axxxidental folded before Flop (didn't bet)
Seat 4: flagao (button) folded before Flop (didn't bet)
Seat 5: jamaralnt (small blind) collected (1025)
Seat 6: wesley18sant (big blind) folded before Flop
Seat 7: alebitenco folded before Flop (didn't bet)
Seat 8: intelllect folded before Flop (didn't bet)
Seat 9: cowbicha folded before Flop (didn't bet)



PokerStars Hand #189312885974: Tournament #2369778109, $0.23+$0.02 USD Hold'em No Limit - Level IX (200/400) - 2018/07/29 21:38:00 ET
Table '2369778109 3' 9-max Seat #5 is the button
Seat 1: MegadethChug (5781 in chips) 
Seat 2: dioclecio13 (2915 in chips) 
Seat 3: Axxxidental (7863 in chips) 
Seat 4: flagao (16167 in chips) 
Seat 5: jamaralnt (14199 in chips) 
Seat 6: wesley18sant (5302 in chips) 
Seat 7: alebitenco (5942 in chips) 
Seat 8: intelllect (1489 in chips) 
Seat 9: cowbicha (7842 in chips) 
MegadethChug: posts the ante 25
dioclecio13: posts the ante 25
Axxxidental: posts the ante 25
flagao: posts the ante 25
jamaralnt: posts the ante 25
wesley18sant: posts the ante 25
alebitenco: posts the ante 25
intelllect: posts the ante 25
cowbicha: posts the ante 25
wesley18sant: posts small blind 200
alebitenco: posts big blind 400
*** HOLE CARDS ***
Dealt to flagao [6h 5s]
intelllect: folds 
cowbicha: folds 
MegadethChug: folds 
dioclecio13: folds 
Axxxidental: folds 
flagao: folds 
jamaralnt: folds 
wesley18sant: folds 
Uncalled bet (200) returned to alebitenco
alebitenco collected 625 from pot
alebitenco: doesn't show hand 
*** SUMMARY ***
Total pot 625 | Rake 0 
Seat 1: MegadethChug folded before Flop (didn't bet)
Seat 2: dioclecio13 folded before Flop (didn't bet)
Seat 3: Axxxidental folded before Flop (didn't bet)
Seat 4: flagao folded before Flop (didn't bet)
Seat 5: jamaralnt (button) folded before Flop (didn't bet)
Seat 6: wesley18sant (small blind) folded before Flop
Seat 7: alebitenco (big blind) collected (625)
Seat 8: intelllect folded before Flop (didn't bet)
Seat 9: cowbicha folded before Flop (didn't bet)



PokerStars Hand #189312891525: Tournament #2369778109, $0.23+$0.02 USD Hold'em No Limit - Level IX (200/400) - 2018/07/29 21:38:16 ET
Table '2369778109 3' 9-max Seat #6 is the button
Seat 1: MegadethChug (5756 in chips) 
Seat 2: dioclecio13 (2890 in chips) 
Seat 3: Axxxidental (7838 in chips) 
Seat 4: flagao (16142 in chips) 
Seat 5: jamaralnt (14174 in chips) 
Seat 6: wesley18sant (5077 in chips) 
Seat 7: alebitenco (6342 in chips) 
Seat 8: intelllect (1464 in chips) 
Seat 9: cowbicha (7817 in chips) 
MegadethChug: posts the ante 25
dioclecio13: posts the ante 25
Axxxidental: posts the ante 25
flagao: posts the ante 25
jamaralnt: posts the ante 25
wesley18sant: posts the ante 25
alebitenco: posts the ante 25
intelllect: posts the ante 25
cowbicha: posts the ante 25
alebitenco: posts small blind 200
intelllect: posts big blind 400
*** HOLE CARDS ***
Dealt to flagao [5d 2d]
cowbicha: folds 
MegadethChug: calls 400
dioclecio13: folds 
Axxxidental: folds 
flagao: folds 
jamaralnt: folds 
wesley18sant: folds 
alebitenco: folds 
intelllect: checks 
*** FLOP *** [4d 3h 4s]
intelllect: checks 
MegadethChug: bets 2000
intelllect: folds 
Uncalled bet (2000) returned to MegadethChug
MegadethChug collected 1225 from pot
*** SUMMARY ***
Total pot 1225 | Rake 0 
Board [4d 3h 4s]
Seat 1: MegadethChug collected (1225)
Seat 2: dioclecio13 folded before Flop (didn't bet)
Seat 3: Axxxidental folded before Flop (didn't bet)
Seat 4: flagao folded before Flop (didn't bet)
Seat 5: jamaralnt folded before Flop (didn't bet)
Seat 6: wesley18sant (button) folded before Flop (didn't bet)
Seat 7: alebitenco (small blind) folded before Flop
Seat 8: intelllect (big blind) folded on the Flop
Seat 9: cowbicha folded before Flop (didn't bet)



PokerStars Hand #189312908586: Tournament #2369778109, $0.23+$0.02 USD Hold'em No Limit - Level IX (200/400) - 2018/07/29 21:39:05 ET
Table '2369778109 3' 9-max Seat #7 is the button
Seat 1: MegadethChug (6556 in chips) 
Seat 2: dioclecio13 (2865 in chips) 
Seat 3: Axxxidental (7813 in chips) 
Seat 4: flagao (16117 in chips) 
Seat 5: jamaralnt (14149 in chips) 
Seat 6: wesley18sant (5052 in chips) 
Seat 7: alebitenco (6117 in chips) 
Seat 8: intelllect (1039 in chips) 
Seat 9: cowbicha (7792 in chips) 
MegadethChug: posts the ante 25
dioclecio13: posts the ante 25
Axxxidental: posts the ante 25
flagao: posts the ante 25
jamaralnt: posts the ante 25
wesley18sant: posts the ante 25
alebitenco: posts the ante 25
intelllect: posts the ante 25
cowbicha: posts the ante 25
intelllect: posts small blind 200
cowbicha: posts big blind 400
*** HOLE CARDS ***
Dealt to flagao [8c Kd]
MegadethChug: folds 
dioclecio13: folds 
Axxxidental: folds 
flagao: folds 
jamaralnt: folds 
wesley18sant: folds 
alebitenco: folds 
intelllect: raises 614 to 1014 and is all-in
cowbicha: calls 614
*** FLOP *** [9d 6s 6d]
*** TURN *** [9d 6s 6d] [3d]
*** RIVER *** [9d 6s 6d 3d] [7s]
*** SHOW DOWN ***
intelllect: shows [Ks 7c] (two pair, Sevens and Sixes)
cowbicha: shows [Jh 6h] (three of a kind, Sixes)
cowbicha collected 2253 from pot
intelllect finished the tournament in 9th place
*** SUMMARY ***
Total pot 2253 | Rake 0 
Board [9d 6s 6d 3d 7s]
Seat 1: MegadethChug folded before Flop (didn't bet)
Seat 2: dioclecio13 folded before Flop (didn't bet)
Seat 3: Axxxidental folded before Flop (didn't bet)
Seat 4: flagao folded before Flop (didn't bet)
Seat 5: jamaralnt folded before Flop (didn't bet)
Seat 6: wesley18sant folded before Flop (didn't bet)
Seat 7: alebitenco (button) folded before Flop (didn't bet)
Seat 8: intelllect (small blind) showed [Ks 7c] and lost with two pair, Sevens and Sixes
Seat 9: cowbicha (big blind) showed [Jh 6h] and won (2253) with three of a kind, Sixes



PokerStars Hand #189312923207: Tournament #2369778109, $0.23+$0.02 USD Hold'em No Limit - Level IX (200/400) - 2018/07/29 21:39:47 ET
Table '2369778109 3' 9-max Seat #9 is the button
Seat 1: MegadethChug (6531 in chips) 
Seat 2: dioclecio13 (2840 in chips) 
Seat 3: Axxxidental (7788 in chips) 
Seat 4: flagao (16092 in chips) 
Seat 5: jamaralnt (14124 in chips) 
Seat 6: wesley18sant (5027 in chips) 
Seat 7: alebitenco (6092 in chips) 
Seat 9: cowbicha (9006 in chips) 
MegadethChug: posts the ante 25
dioclecio13: posts the ante 25
Axxxidental: posts the ante 25
flagao: posts the ante 25
jamaralnt: posts the ante 25
wesley18sant: posts the ante 25
alebitenco: posts the ante 25
cowbicha: posts the ante 25
MegadethChug: posts small blind 200
dioclecio13: posts big blind 400
*** HOLE CARDS ***
Dealt to flagao [3c Qd]
Axxxidental: folds 
flagao: folds 
jamaralnt: folds 
wesley18sant: folds 
alebitenco: folds 
cowbicha: folds 
MegadethChug: calls 200
dioclecio13: checks 
*** FLOP *** [8d 6h 4s]
MegadethChug: checks 
dioclecio13: bets 2415 and is all-in
MegadethChug: folds 
Uncalled bet (2415) returned to dioclecio13
dioclecio13 collected 1000 from pot
dioclecio13: doesn't show hand 
*** SUMMARY ***
Total pot 1000 | Rake 0 
Board [8d 6h 4s]
Seat 1: MegadethChug (small blind) folded on the Flop
Seat 2: dioclecio13 (big blind) collected (1000)
Seat 3: Axxxidental folded before Flop (didn't bet)
Seat 4: flagao folded before Flop (didn't bet)
Seat 5: jamaralnt folded before Flop (didn't bet)
Seat 6: wesley18sant folded before Flop (didn't bet)
Seat 7: alebitenco folded before Flop (didn't bet)
Seat 9: cowbicha (button) folded before Flop (didn't bet)



PokerStars Hand #189312935427: Tournament #2369778109, $0.23+$0.02 USD Hold'em No Limit - Level IX (200/400) - 2018/07/29 21:40:22 ET
Table '2369778109 3' 9-max Seat #1 is the button
Seat 1: MegadethChug (6106 in chips) 
Seat 2: dioclecio13 (3415 in chips) 
Seat 3: Axxxidental (7763 in chips) 
Seat 4: flagao (16067 in chips) 
Seat 5: jamaralnt (14099 in chips) 
Seat 6: wesley18sant (5002 in chips) 
Seat 7: alebitenco (6067 in chips) 
Seat 9: cowbicha (8981 in chips) 
MegadethChug: posts the ante 25
dioclecio13: posts the ante 25
Axxxidental: posts the ante 25
flagao: posts the ante 25
jamaralnt: posts the ante 25
wesley18sant: posts the ante 25
alebitenco: posts the ante 25
cowbicha: posts the ante 25
dioclecio13: posts small blind 200
Axxxidental: posts big blind 400
*** HOLE CARDS ***
Dealt to flagao [Kc 2c]
flagao: folds 
jamaralnt: raises 400 to 800
wesley18sant: folds 
alebitenco: folds 
cowbicha: folds 
MegadethChug: folds 
dioclecio13: folds 
Axxxidental: folds 
Uncalled bet (400) returned to jamaralnt
jamaralnt collected 1200 from pot
jamaralnt: doesn't show hand 
*** SUMMARY ***
Total pot 1200 | Rake 0 
Seat 1: MegadethChug (button) folded before Flop (didn't bet)
Seat 2: dioclecio13 (small blind) folded before Flop
Seat 3: Axxxidental (big blind) folded before Flop
Seat 4: flagao folded before Flop (didn't bet)
Seat 5: jamaralnt collected (1200)
Seat 6: wesley18sant folded before Flop (didn't bet)
Seat 7: alebitenco folded before Flop (didn't bet)
Seat 9: cowbicha folded before Flop (didn't bet)



PokerStars Hand #189312948889: Tournament #2369778109, $0.23+$0.02 USD Hold'em No Limit - Level IX (200/400) - 2018/07/29 21:41:01 ET
Table '2369778109 3' 9-max Seat #2 is the button
Seat 1: MegadethChug (6081 in chips) 
Seat 2: dioclecio13 (3190 in chips) 
Seat 3: Axxxidental (7338 in chips) 
Seat 4: flagao (16042 in chips) 
Seat 5: jamaralnt (14874 in chips) 
Seat 6: wesley18sant (4977 in chips) 
Seat 7: alebitenco (6042 in chips) 
Seat 9: cowbicha (8956 in chips) 
MegadethChug: posts the ante 25
dioclecio13: posts the ante 25
Axxxidental: posts the ante 25
flagao: posts the ante 25
jamaralnt: posts the ante 25
wesley18sant: posts the ante 25
alebitenco: posts the ante 25
cowbicha: posts the ante 25
Axxxidental: posts small blind 200
flagao: posts big blind 400
*** HOLE CARDS ***
Dealt to flagao [As Tc]
jamaralnt: folds 
wesley18sant: folds 
alebitenco: raises 444 to 844
cowbicha: folds 
MegadethChug: folds 
dioclecio13: folds 
Axxxidental: folds 
flagao: calls 444
*** FLOP *** [Qh 7d 5c]
flagao: checks 
alebitenco: bets 1065
flagao: folds 
Uncalled bet (1065) returned to alebitenco
alebitenco collected 2088 from pot
alebitenco: doesn't show hand 
*** SUMMARY ***
Total pot 2088 | Rake 0 
Board [Qh 7d 5c]
Seat 1: MegadethChug folded before Flop (didn't bet)
Seat 2: dioclecio13 (button) folded before Flop (didn't bet)
Seat 3: Axxxidental (small blind) folded before Flop
Seat 4: flagao (big blind) folded on the Flop
Seat 5: jamaralnt folded before Flop (didn't bet)
Seat 6: wesley18sant folded before Flop (didn't bet)
Seat 7: alebitenco collected (2088)
Seat 9: cowbicha folded before Flop (didn't bet)



PokerStars Hand #189312962426: Tournament #2369778109, $0.23+$0.02 USD Hold'em No Limit - Level IX (200/400) - 2018/07/29 21:41:40 ET
Table '2369778109 3' 9-max Seat #3 is the button
Seat 1: MegadethChug (6056 in chips) 
Seat 2: dioclecio13 (3165 in chips) 
Seat 3: Axxxidental (7113 in chips) 
Seat 4: flagao (15173 in chips) 
Seat 5: jamaralnt (14849 in chips) 
Seat 6: wesley18sant (4952 in chips) 
Seat 7: alebitenco (7261 in chips) 
Seat 9: cowbicha (8931 in chips) 
MegadethChug: posts the ante 25
dioclecio13: posts the ante 25
Axxxidental: posts the ante 25
flagao: posts the ante 25
jamaralnt: posts the ante 25
wesley18sant: posts the ante 25
alebitenco: posts the ante 25
cowbicha: posts the ante 25
flagao: posts small blind 200
jamaralnt: posts big blind 400
*** HOLE CARDS ***
Dealt to flagao [3d Js]
wesley18sant: folds 
alebitenco: folds 
cowbicha: folds 
MegadethChug: calls 400
dioclecio13: folds 
Axxxidental: folds 
flagao: folds 
jamaralnt: raises 800 to 1200
MegadethChug: calls 800
*** FLOP *** [9d Qd 6h]
jamaralnt: bets 1600
MegadethChug: folds 
Uncalled bet (1600) returned to jamaralnt
jamaralnt collected 2800 from pot
jamaralnt: doesn't show hand 
*** SUMMARY ***
Total pot 2800 | Rake 0 
Board [9d Qd 6h]
Seat 1: MegadethChug folded on the Flop
Seat 2: dioclecio13 folded before Flop (didn't bet)
Seat 3: Axxxidental (button) folded before Flop (didn't bet)
Seat 4: flagao (small blind) folded before Flop
Seat 5: jamaralnt (big blind) collected (2800)
Seat 6: wesley18sant folded before Flop (didn't bet)
Seat 7: alebitenco folded before Flop (didn't bet)
Seat 9: cowbicha folded before Flop (didn't bet)



PokerStars Hand #189312981268: Tournament #2369778109, $0.23+$0.02 USD Hold'em No Limit - Level IX (200/400) - 2018/07/29 21:42:35 ET
Table '2369778109 3' 9-max Seat #4 is the button
Seat 1: MegadethChug (4831 in chips) 
Seat 2: dioclecio13 (3140 in chips) 
Seat 3: Axxxidental (7088 in chips) 
Seat 4: flagao (14948 in chips) 
Seat 5: jamaralnt (16424 in chips) 
Seat 6: wesley18sant (4927 in chips) 
Seat 7: alebitenco (7236 in chips) 
Seat 9: cowbicha (8906 in chips) 
MegadethChug: posts the ante 25
dioclecio13: posts the ante 25
Axxxidental: posts the ante 25
flagao: posts the ante 25
jamaralnt: posts the ante 25
wesley18sant: posts the ante 25
alebitenco: posts the ante 25
cowbicha: posts the ante 25
jamaralnt: posts small blind 200
wesley18sant: posts big blind 400
*** HOLE CARDS ***
Dealt to flagao [Ks 6c]
alebitenco: folds 
cowbicha: raises 400 to 800
MegadethChug: folds 
dioclecio13: folds 
Axxxidental: folds 
flagao: folds 
jamaralnt: folds 
wesley18sant: folds 
Uncalled bet (400) returned to cowbicha
cowbicha collected 1200 from pot
*** SUMMARY ***
Total pot 1200 | Rake 0 
Seat 1: MegadethChug folded before Flop (didn't bet)
Seat 2: dioclecio13 folded before Flop (didn't bet)
Seat 3: Axxxidental folded before Flop (didn't bet)
Seat 4: flagao (button) folded before Flop (didn't bet)
Seat 5: jamaralnt (small blind) folded before Flop
Seat 6: wesley18sant (big blind) folded before Flop
Seat 7: alebitenco folded before Flop (didn't bet)
Seat 9: cowbicha collected (1200)



PokerStars Hand #189312990820: Tournament #2369778109, $0.23+$0.02 USD Hold'em No Limit - Level IX (200/400) - 2018/07/29 21:43:02 ET
Table '2369778109 3' 9-max Seat #5 is the button
Seat 1: MegadethChug (4806 in chips) 
Seat 2: dioclecio13 (3115 in chips) 
Seat 3: Axxxidental (7063 in chips) 
Seat 4: flagao (14923 in chips) 
Seat 5: jamaralnt (16199 in chips) 
Seat 6: wesley18sant (4502 in chips) 
Seat 7: alebitenco (7211 in chips) 
Seat 9: cowbicha (9681 in chips) 
MegadethChug: posts the ante 25
dioclecio13: posts the ante 25
Axxxidental: posts the ante 25
flagao: posts the ante 25
jamaralnt: posts the ante 25
wesley18sant: posts the ante 25
alebitenco: posts the ante 25
cowbicha: posts the ante 25
wesley18sant: posts small blind 200
alebitenco: posts big blind 400
*** HOLE CARDS ***
Dealt to flagao [3d 7d]
cowbicha: folds 
MegadethChug: folds 
dioclecio13: raises 2690 to 3090 and is all-in
Axxxidental: folds 
flagao: folds 
jamaralnt: folds 
wesley18sant: folds 
alebitenco: folds 
Uncalled bet (2690) returned to dioclecio13
dioclecio13 collected 1200 from pot
dioclecio13: doesn't show hand 
*** SUMMARY ***
Total pot 1200 | Rake 0 
Seat 1: MegadethChug folded before Flop (didn't bet)
Seat 2: dioclecio13 collected (1200)
Seat 3: Axxxidental folded before Flop (didn't bet)
Seat 4: flagao folded before Flop (didn't bet)
Seat 5: jamaralnt (button) folded before Flop (didn't bet)
Seat 6: wesley18sant (small blind) folded before Flop
Seat 7: alebitenco (big blind) folded before Flop
Seat 9: cowbicha folded before Flop (didn't bet)



PokerStars Hand #189313003799: Tournament #2369778109, $0.23+$0.02 USD Hold'em No Limit - Level IX (200/400) - 2018/07/29 21:43:40 ET
Table '2369778109 3' 9-max Seat #6 is the button
Seat 1: MegadethChug (4781 in chips) 
Seat 2: dioclecio13 (3890 in chips) 
Seat 3: Axxxidental (7038 in chips) 
Seat 4: flagao (14898 in chips) 
Seat 5: jamaralnt (16174 in chips) 
Seat 6: wesley18sant (4277 in chips) 
Seat 7: alebitenco (6786 in chips) 
Seat 9: cowbicha (9656 in chips) 
MegadethChug: posts the ante 25
dioclecio13: posts the ante 25
Axxxidental: posts the ante 25
flagao: posts the ante 25
jamaralnt: posts the ante 25
wesley18sant: posts the ante 25
alebitenco: posts the ante 25
cowbicha: posts the ante 25
alebitenco: posts small blind 200
cowbicha: posts big blind 400
*** HOLE CARDS ***
Dealt to flagao [2d 6s]
MegadethChug: folds 
dioclecio13: folds 
Axxxidental: folds 
flagao: folds 
jamaralnt: raises 400 to 800
wesley18sant: folds 
alebitenco: folds 
cowbicha: folds 
Uncalled bet (400) returned to jamaralnt
jamaralnt collected 1200 from pot
jamaralnt: doesn't show hand 
*** SUMMARY ***
Total pot 1200 | Rake 0 
Seat 1: MegadethChug folded before Flop (didn't bet)
Seat 2: dioclecio13 folded before Flop (didn't bet)
Seat 3: Axxxidental folded before Flop (didn't bet)
Seat 4: flagao folded before Flop (didn't bet)
Seat 5: jamaralnt collected (1200)
Seat 6: wesley18sant (button) folded before Flop (didn't bet)
Seat 7: alebitenco (small blind) folded before Flop
Seat 9: cowbicha (big blind) folded before Flop



PokerStars Hand #189313015018: Tournament #2369778109, $0.23+$0.02 USD Hold'em No Limit - Level IX (200/400) - 2018/07/29 21:44:13 ET
Table '2369778109 3' 9-max Seat #7 is the button
Seat 1: MegadethChug (4756 in chips) 
Seat 2: dioclecio13 (3865 in chips) 
Seat 3: Axxxidental (7013 in chips) 
Seat 4: flagao (14873 in chips) 
Seat 5: jamaralnt (16949 in chips) 
Seat 6: wesley18sant (4252 in chips) 
Seat 7: alebitenco (6561 in chips) 
Seat 9: cowbicha (9231 in chips) 
MegadethChug: posts the ante 25
dioclecio13: posts the ante 25
Axxxidental: posts the ante 25
flagao: posts the ante 25
jamaralnt: posts the ante 25
wesley18sant: posts the ante 25
alebitenco: posts the ante 25
cowbicha: posts the ante 25
cowbicha: posts small blind 200
MegadethChug: posts big blind 400
*** HOLE CARDS ***
Dealt to flagao [9h Ks]
dioclecio13: folds 
Axxxidental: folds 
flagao: folds 
jamaralnt: raises 400 to 800
wesley18sant: folds 
alebitenco: folds 
cowbicha: folds 
MegadethChug: folds 
Uncalled bet (400) returned to jamaralnt
jamaralnt collected 1200 from pot
jamaralnt: doesn't show hand 
*** SUMMARY ***
Total pot 1200 | Rake 0 
Seat 1: MegadethChug (big blind) folded before Flop
Seat 2: dioclecio13 folded before Flop (didn't bet)
Seat 3: Axxxidental folded before Flop (didn't bet)
Seat 4: flagao folded before Flop (didn't bet)
Seat 5: jamaralnt collected (1200)
Seat 6: wesley18sant folded before Flop (didn't bet)
Seat 7: alebitenco (button) folded before Flop (didn't bet)
Seat 9: cowbicha (small blind) folded before Flop



PokerStars Hand #189313024451: Tournament #2369778109, $0.23+$0.02 USD Hold'em No Limit - Level IX (200/400) - 2018/07/29 21:44:40 ET
Table '2369778109 3' 9-max Seat #9 is the button
Seat 1: MegadethChug (4331 in chips) 
Seat 2: dioclecio13 (3840 in chips) 
Seat 3: Axxxidental (6988 in chips) 
Seat 4: flagao (14848 in chips) 
Seat 5: jamaralnt (17724 in chips) 
Seat 6: wesley18sant (4227 in chips) 
Seat 7: alebitenco (6536 in chips) 
Seat 9: cowbicha (9006 in chips) 
MegadethChug: posts the ante 25
dioclecio13: posts the ante 25
Axxxidental: posts the ante 25
flagao: posts the ante 25
jamaralnt: posts the ante 25
wesley18sant: posts the ante 25
alebitenco: posts the ante 25
cowbicha: posts the ante 25
MegadethChug: posts small blind 200
dioclecio13: posts big blind 400
*** HOLE CARDS ***
Dealt to flagao [Qd 4d]
Axxxidental: folds 
flagao: folds 
jamaralnt: folds 
wesley18sant: folds 
alebitenco: folds 
cowbicha: raises 400 to 800
MegadethChug: folds 
dioclecio13: folds 
Uncalled bet (400) returned to cowbicha
cowbicha collected 1200 from pot
*** SUMMARY ***
Total pot 1200 | Rake 0 
Seat 1: MegadethChug (small blind) folded before Flop
Seat 2: dioclecio13 (big blind) folded before Flop
Seat 3: Axxxidental folded before Flop (didn't bet)
Seat 4: flagao folded before Flop (didn't bet)
Seat 5: jamaralnt folded before Flop (didn't bet)
Seat 6: wesley18sant folded before Flop (didn't bet)
Seat 7: alebitenco folded before Flop (didn't bet)
Seat 9: cowbicha (button) collected (1200)



PokerStars Hand #189313034939: Tournament #2369778109, $0.23+$0.02 USD Hold'em No Limit - Level IX (200/400) - 2018/07/29 21:45:11 ET
Table '2369778109 3' 9-max Seat #1 is the button
Seat 1: MegadethChug (4106 in chips) 
Seat 2: dioclecio13 (3415 in chips) 
Seat 3: Axxxidental (6963 in chips) 
Seat 4: flagao (14823 in chips) 
Seat 5: jamaralnt (17699 in chips) 
Seat 6: wesley18sant (4202 in chips) 
Seat 7: alebitenco (6511 in chips) 
Seat 9: cowbicha (9781 in chips) 
MegadethChug: posts the ante 25
dioclecio13: posts the ante 25
Axxxidental: posts the ante 25
flagao: posts the ante 25
jamaralnt: posts the ante 25
wesley18sant: posts the ante 25
alebitenco: posts the ante 25
cowbicha: posts the ante 25
dioclecio13: posts small blind 200
Axxxidental: posts big blind 400
*** HOLE CARDS ***
Dealt to flagao [Qs 3d]
flagao: folds 
jamaralnt: raises 400 to 800
wesley18sant: folds 
alebitenco: folds 
cowbicha: folds 
MegadethChug: raises 3281 to 4081 and is all-in
dioclecio13: folds 
Axxxidental: folds 
jamaralnt: calls 3281
*** FLOP *** [7s 5d Ad]
*** TURN *** [7s 5d Ad] [9s]
*** RIVER *** [7s 5d Ad 9s] [Jc]
*** SHOW DOWN ***
jamaralnt: shows [As 2s] (a pair of Aces)
MegadethChug: shows [Ac 9d] (two pair, Aces and Nines)
MegadethChug collected 8962 from pot
*** SUMMARY ***
Total pot 8962 | Rake 0 
Board [7s 5d Ad 9s Jc]
Seat 1: MegadethChug (button) showed [Ac 9d] and won (8962) with two pair, Aces and Nines
Seat 2: dioclecio13 (small blind) folded before Flop
Seat 3: Axxxidental (big blind) folded before Flop
Seat 4: flagao folded before Flop (didn't bet)
Seat 5: jamaralnt showed [As 2s] and lost with a pair of Aces
Seat 6: wesley18sant folded before Flop (didn't bet)
Seat 7: alebitenco folded before Flop (didn't bet)
Seat 9: cowbicha folded before Flop (didn't bet)



PokerStars Hand #189313045046: Tournament #2369778109, $0.23+$0.02 USD Hold'em No Limit - Level IX (200/400) - 2018/07/29 21:45:41 ET
Table '2369778109 3' 9-max Seat #2 is the button
Seat 1: MegadethChug (8962 in chips) 
Seat 2: dioclecio13 (3190 in chips) 
Seat 3: Axxxidental (6538 in chips) 
Seat 4: flagao (14798 in chips) 
Seat 5: jamaralnt (13593 in chips) 
Seat 6: wesley18sant (4177 in chips) 
Seat 7: alebitenco (6486 in chips) 
Seat 9: cowbicha (9756 in chips) 
MegadethChug: posts the ante 25
dioclecio13: posts the ante 25
Axxxidental: posts the ante 25
flagao: posts the ante 25
jamaralnt: posts the ante 25
wesley18sant: posts the ante 25
alebitenco: posts the ante 25
cowbicha: posts the ante 25
Axxxidental: posts small blind 200
flagao: posts big blind 400
*** HOLE CARDS ***
Dealt to flagao [As 5c]
jamaralnt: folds 
wesley18sant: folds 
alebitenco: folds 
cowbicha: folds 
MegadethChug: folds 
dioclecio13: folds 
Axxxidental: folds 
Uncalled bet (200) returned to flagao
flagao collected 600 from pot
flagao: doesn't show hand 
*** SUMMARY ***
Total pot 600 | Rake 0 
Seat 1: MegadethChug folded before Flop (didn't bet)
Seat 2: dioclecio13 (button) folded before Flop (didn't bet)
Seat 3: Axxxidental (small blind) folded before Flop
Seat 4: flagao (big blind) collected (600)
Seat 5: jamaralnt folded before Flop (didn't bet)
Seat 6: wesley18sant folded before Flop (didn't bet)
Seat 7: alebitenco folded before Flop (didn't bet)
Seat 9: cowbicha folded before Flop (didn't bet)



PokerStars Hand #189313055172: Tournament #2369778109, $0.23+$0.02 USD Hold'em No Limit - Level IX (200/400) - 2018/07/29 21:46:10 ET
Table '2369778109 3' 9-max Seat #3 is the button
Seat 1: MegadethChug (8937 in chips) 
Seat 2: dioclecio13 (3165 in chips) 
Seat 3: Axxxidental (6313 in chips) 
Seat 4: flagao (15173 in chips) 
Seat 5: jamaralnt (13568 in chips) 
Seat 6: wesley18sant (4152 in chips) 
Seat 7: alebitenco (6461 in chips) 
Seat 9: cowbicha (9731 in chips) 
MegadethChug: posts the ante 25
dioclecio13: posts the ante 25
Axxxidental: posts the ante 25
flagao: posts the ante 25
jamaralnt: posts the ante 25
wesley18sant: posts the ante 25
alebitenco: posts the ante 25
cowbicha: posts the ante 25
flagao: posts small blind 200
jamaralnt: posts big blind 400
*** HOLE CARDS ***
Dealt to flagao [6s 6d]
wesley18sant: folds 
alebitenco: folds 
cowbicha: folds 
MegadethChug: folds 
dioclecio13: folds 
Axxxidental: folds 
flagao: raises 400 to 800
jamaralnt: folds 
Uncalled bet (400) returned to flagao
flagao collected 1000 from pot
flagao: doesn't show hand 
*** SUMMARY ***
Total pot 1000 | Rake 0 
Seat 1: MegadethChug folded before Flop (didn't bet)
Seat 2: dioclecio13 folded before Flop (didn't bet)
Seat 3: Axxxidental (button) folded before Flop (didn't bet)
Seat 4: flagao (small blind) collected (1000)
Seat 5: jamaralnt (big blind) folded before Flop
Seat 6: wesley18sant folded before Flop (didn't bet)
Seat 7: alebitenco folded before Flop (didn't bet)
Seat 9: cowbicha folded before Flop (didn't bet)



PokerStars Hand #189313065898: Tournament #2369778109, $0.23+$0.02 USD Hold'em No Limit - Level IX (200/400) - 2018/07/29 21:46:42 ET
Table '2369778109 3' 9-max Seat #4 is the button
Seat 1: MegadethChug (8912 in chips) 
Seat 2: dioclecio13 (3140 in chips) 
Seat 3: Axxxidental (6288 in chips) 
Seat 4: flagao (15748 in chips) 
Seat 5: jamaralnt (13143 in chips) 
Seat 6: wesley18sant (4127 in chips) 
Seat 7: alebitenco (6436 in chips) 
Seat 9: cowbicha (9706 in chips) 
MegadethChug: posts the ante 25
dioclecio13: posts the ante 25
Axxxidental: posts the ante 25
flagao: posts the ante 25
jamaralnt: posts the ante 25
wesley18sant: posts the ante 25
alebitenco: posts the ante 25
cowbicha: posts the ante 25
jamaralnt: posts small blind 200
wesley18sant: posts big blind 400
*** HOLE CARDS ***
Dealt to flagao [9h Kc]
alebitenco: folds 
cowbicha: folds 
MegadethChug: raises 400 to 800
dioclecio13: folds 
Axxxidental: folds 
flagao: folds 
jamaralnt: raises 800 to 1600
wesley18sant: folds 
MegadethChug: calls 800
*** FLOP *** [4h 6s 6h]
jamaralnt: bets 2660
MegadethChug: folds 
Uncalled bet (2660) returned to jamaralnt
jamaralnt collected 3800 from pot
jamaralnt: doesn't show hand 
*** SUMMARY ***
Total pot 3800 | Rake 0 
Board [4h 6s 6h]
Seat 1: MegadethChug folded on the Flop
Seat 2: dioclecio13 folded before Flop (didn't bet)
Seat 3: Axxxidental folded before Flop (didn't bet)
Seat 4: flagao (button) folded before Flop (didn't bet)
Seat 5: jamaralnt (small blind) collected (3800)
Seat 6: wesley18sant (big blind) folded before Flop
Seat 7: alebitenco folded before Flop (didn't bet)
Seat 9: cowbicha folded before Flop (didn't bet)



PokerStars Hand #189313079283: Tournament #2369778109, $0.23+$0.02 USD Hold'em No Limit - Level IX (200/400) - 2018/07/29 21:47:22 ET
Table '2369778109 3' 9-max Seat #5 is the button
Seat 1: MegadethChug (7287 in chips) 
Seat 2: dioclecio13 (3115 in chips) 
Seat 3: Axxxidental (6263 in chips) 
Seat 4: flagao (15723 in chips) 
Seat 5: jamaralnt (15318 in chips) 
Seat 6: wesley18sant (3702 in chips) 
Seat 7: alebitenco (6411 in chips) 
Seat 9: cowbicha (9681 in chips) 
MegadethChug: posts the ante 25
dioclecio13: posts the ante 25
Axxxidental: posts the ante 25
flagao: posts the ante 25
jamaralnt: posts the ante 25
wesley18sant: posts the ante 25
alebitenco: posts the ante 25
cowbicha: posts the ante 25
wesley18sant: posts small blind 200
alebitenco: posts big blind 400
*** HOLE CARDS ***
Dealt to flagao [8c 4d]
cowbicha: folds 
MegadethChug: folds 
dioclecio13: folds 
Axxxidental: folds 
flagao: folds 
jamaralnt: folds 
wesley18sant: folds 
Uncalled bet (200) returned to alebitenco
alebitenco collected 600 from pot
alebitenco: doesn't show hand 
*** SUMMARY ***
Total pot 600 | Rake 0 
Seat 1: MegadethChug folded before Flop (didn't bet)
Seat 2: dioclecio13 folded before Flop (didn't bet)
Seat 3: Axxxidental folded before Flop (didn't bet)
Seat 4: flagao folded before Flop (didn't bet)
Seat 5: jamaralnt (button) folded before Flop (didn't bet)
Seat 6: wesley18sant (small blind) folded before Flop
Seat 7: alebitenco (big blind) collected (600)
Seat 9: cowbicha folded before Flop (didn't bet)



PokerStars Hand #189313085381: Tournament #2369778109, $0.23+$0.02 USD Hold'em No Limit - Level X (300/600) - 2018/07/29 21:47:40 ET
Table '2369778109 3' 9-max Seat #6 is the button
Seat 1: MegadethChug (7262 in chips) 
Seat 2: dioclecio13 (3090 in chips) 
Seat 3: Axxxidental (6238 in chips) 
Seat 4: flagao (15698 in chips) 
Seat 5: jamaralnt (15293 in chips) 
Seat 6: wesley18sant (3477 in chips) 
Seat 7: alebitenco (6786 in chips) 
Seat 9: cowbicha (9656 in chips) 
MegadethChug: posts the ante 50
dioclecio13: posts the ante 50
Axxxidental: posts the ante 50
flagao: posts the ante 50
jamaralnt: posts the ante 50
wesley18sant: posts the ante 50
alebitenco: posts the ante 50
cowbicha: posts the ante 50
alebitenco: posts small blind 300
cowbicha: posts big blind 600
*** HOLE CARDS ***
Dealt to flagao [7c 6s]
MegadethChug: folds 
dioclecio13: folds 
Axxxidental: folds 
flagao: folds 
jamaralnt: raises 600 to 1200
wesley18sant: folds 
alebitenco: folds 
cowbicha: calls 600
*** FLOP *** [Kc 6c 3s]
cowbicha: checks 
jamaralnt: checks 
*** TURN *** [Kc 6c 3s] [As]
cowbicha: bets 900
jamaralnt: calls 900
*** RIVER *** [Kc 6c 3s As] [6d]
cowbicha: checks 
jamaralnt: bets 3430
cowbicha: folds 
Uncalled bet (3430) returned to jamaralnt
jamaralnt collected 4900 from pot
jamaralnt: doesn't show hand 
*** SUMMARY ***
Total pot 4900 | Rake 0 
Board [Kc 6c 3s As 6d]
Seat 1: MegadethChug folded before Flop (didn't bet)
Seat 2: dioclecio13 folded before Flop (didn't bet)
Seat 3: Axxxidental folded before Flop (didn't bet)
Seat 4: flagao folded before Flop (didn't bet)
Seat 5: jamaralnt collected (4900)
Seat 6: wesley18sant (button) folded before Flop (didn't bet)
Seat 7: alebitenco (small blind) folded before Flop
Seat 9: cowbicha (big blind) folded on the River



PokerStars Hand #189313112061: Tournament #2369778109, $0.23+$0.02 USD Hold'em No Limit - Level X (300/600) - 2018/07/29 21:48:38 ET
Table '2369778109 3' 9-max Seat #7 is the button
Seat 1: MegadethChug (7212 in chips) 
Seat 2: dioclecio13 (3040 in chips) 
Seat 3: Axxxidental (6188 in chips) 
Seat 4: flagao (15648 in chips) 
Seat 5: jamaralnt (18043 in chips) 
Seat 6: wesley18sant (3427 in chips) 
Seat 7: alebitenco (6436 in chips) 
Seat 9: cowbicha (7506 in chips) 
MegadethChug: posts the ante 50
dioclecio13: posts the ante 50
Axxxidental: posts the ante 50
flagao: posts the ante 50
jamaralnt: posts the ante 50
wesley18sant: posts the ante 50
alebitenco: posts the ante 50
cowbicha: posts the ante 50
cowbicha: posts small blind 300
MegadethChug: posts big blind 600
*** HOLE CARDS ***
Dealt to flagao [2h 3s]
dioclecio13: folds 
Axxxidental: folds 
flagao: folds 
jamaralnt: folds 
wesley18sant: folds 
alebitenco: raises 600 to 1200
cowbicha: raises 600 to 1800
MegadethChug: folds 
alebitenco: calls 600
*** FLOP *** [7c 9s Qh]
cowbicha: bets 1200
alebitenco: raises 1200 to 2400
cowbicha: raises 3256 to 5656 and is all-in
alebitenco: calls 2186 and is all-in
Uncalled bet (1070) returned to cowbicha
*** TURN *** [7c 9s Qh] [Qs]
*** RIVER *** [7c 9s Qh Qs] [Th]
*** SHOW DOWN ***
cowbicha: shows [As Ac] (two pair, Aces and Queens)
alebitenco: shows [Qd 9c] (a full house, Queens full of Nines)
alebitenco collected 13772 from pot
*** SUMMARY ***
Total pot 13772 | Rake 0 
Board [7c 9s Qh Qs Th]
Seat 1: MegadethChug (big blind) folded before Flop
Seat 2: dioclecio13 folded before Flop (didn't bet)
Seat 3: Axxxidental folded before Flop (didn't bet)
Seat 4: flagao folded before Flop (didn't bet)
Seat 5: jamaralnt folded before Flop (didn't bet)
Seat 6: wesley18sant folded before Flop (didn't bet)
Seat 7: alebitenco (button) showed [Qd 9c] and won (13772) with a full house, Queens full of Nines
Seat 9: cowbicha (small blind) showed [As Ac] and lost with two pair, Aces and Queens



PokerStars Hand #189313129211: Tournament #2369778109, $0.23+$0.02 USD Hold'em No Limit - Level X (300/600) - 2018/07/29 21:49:29 ET
Table '2369778109 3' 9-max Seat #9 is the button
Seat 1: MegadethChug (6562 in chips) 
Seat 2: dioclecio13 (2990 in chips) 
Seat 3: Axxxidental (6138 in chips) 
Seat 4: flagao (15598 in chips) 
Seat 5: jamaralnt (17993 in chips) 
Seat 6: wesley18sant (3377 in chips) 
Seat 7: alebitenco (13772 in chips) 
Seat 9: cowbicha (1070 in chips) 
MegadethChug: posts the ante 50
dioclecio13: posts the ante 50
Axxxidental: posts the ante 50
flagao: posts the ante 50
jamaralnt: posts the ante 50
wesley18sant: posts the ante 50
alebitenco: posts the ante 50
cowbicha: posts the ante 50
MegadethChug: posts small blind 300
dioclecio13: posts big blind 600
*** HOLE CARDS ***
Dealt to flagao [3c 5h]
Axxxidental: folds 
flagao: folds 
jamaralnt: folds 
wesley18sant: folds 
alebitenco: folds 
cowbicha: raises 420 to 1020 and is all-in
MegadethChug: folds 
dioclecio13: calls 420
*** FLOP *** [Qh Ks 6d]
*** TURN *** [Qh Ks 6d] [8d]
*** RIVER *** [Qh Ks 6d 8d] [5d]
*** SHOW DOWN ***
dioclecio13: shows [2h 7s] (high card King)
cowbicha: shows [4s Kc] (a pair of Kings)
cowbicha collected 2740 from pot
*** SUMMARY ***
Total pot 2740 | Rake 0 
Board [Qh Ks 6d 8d 5d]
Seat 1: MegadethChug (small blind) folded before Flop
Seat 2: dioclecio13 (big blind) showed [2h 7s] and lost with high card King
Seat 3: Axxxidental folded before Flop (didn't bet)
Seat 4: flagao folded before Flop (didn't bet)
Seat 5: jamaralnt folded before Flop (didn't bet)
Seat 6: wesley18sant folded before Flop (didn't bet)
Seat 7: alebitenco folded before Flop (didn't bet)
Seat 9: cowbicha (button) showed [4s Kc] and won (2740) with a pair of Kings



PokerStars Hand #189313137080: Tournament #2369778109, $0.23+$0.02 USD Hold'em No Limit - Level X (300/600) - 2018/07/29 21:49:53 ET
Table '2369778109 3' 9-max Seat #1 is the button
Seat 1: MegadethChug (6212 in chips) 
Seat 2: dioclecio13 (1920 in chips) 
Seat 3: Axxxidental (6088 in chips) 
Seat 4: flagao (15548 in chips) 
Seat 5: jamaralnt (17943 in chips) 
Seat 6: wesley18sant (3327 in chips) 
Seat 7: alebitenco (13722 in chips) 
Seat 9: cowbicha (2740 in chips) 
MegadethChug: posts the ante 50
dioclecio13: posts the ante 50
Axxxidental: posts the ante 50
flagao: posts the ante 50
jamaralnt: posts the ante 50
wesley18sant: posts the ante 50
alebitenco: posts the ante 50
cowbicha: posts the ante 50
dioclecio13: posts small blind 300
Axxxidental: posts big blind 600
*** HOLE CARDS ***
Dealt to flagao [As Tc]
flagao: raises 600 to 1200
jamaralnt: folds 
wesley18sant: folds 
alebitenco: folds 
cowbicha: raises 1490 to 2690 and is all-in
MegadethChug: folds 
dioclecio13: folds 
Axxxidental: folds 
flagao: calls 1490
*** FLOP *** [8d 3s 5d]
*** TURN *** [8d 3s 5d] [5c]
*** RIVER *** [8d 3s 5d 5c] [Ks]
*** SHOW DOWN ***
flagao: shows [As Tc] (a pair of Fives)
cowbicha: shows [5s Qs] (three of a kind, Fives)
cowbicha collected 6680 from pot
*** SUMMARY ***
Total pot 6680 | Rake 0 
Board [8d 3s 5d 5c Ks]
Seat 1: MegadethChug (button) folded before Flop (didn't bet)
Seat 2: dioclecio13 (small blind) folded before Flop
Seat 3: Axxxidental (big blind) folded before Flop
Seat 4: flagao showed [As Tc] and lost with a pair of Fives
Seat 5: jamaralnt folded before Flop (didn't bet)
Seat 6: wesley18sant folded before Flop (didn't bet)
Seat 7: alebitenco folded before Flop (didn't bet)
Seat 9: cowbicha showed [5s Qs] and won (6680) with three of a kind, Fives



PokerStars Hand #189313148369: Tournament #2369778109, $0.23+$0.02 USD Hold'em No Limit - Level X (300/600) - 2018/07/29 21:50:26 ET
Table '2369778109 3' 9-max Seat #2 is the button
Seat 1: MegadethChug (6162 in chips) 
Seat 2: dioclecio13 (1570 in chips) 
Seat 3: Axxxidental (5438 in chips) 
Seat 4: flagao (12808 in chips) 
Seat 5: jamaralnt (17893 in chips) 
Seat 6: wesley18sant (3277 in chips) 
Seat 7: alebitenco (13672 in chips) 
Seat 9: cowbicha (6680 in chips) 
MegadethChug: posts the ante 50
dioclecio13: posts the ante 50
Axxxidental: posts the ante 50
flagao: posts the ante 50
jamaralnt: posts the ante 50
wesley18sant: posts the ante 50
alebitenco: posts the ante 50
cowbicha: posts the ante 50
Axxxidental: posts small blind 300
flagao: posts big blind 600
*** HOLE CARDS ***
Dealt to flagao [9d 5s]
jamaralnt: raises 600 to 1200
wesley18sant has timed out
wesley18sant: folds 
wesley18sant is sitting out
alebitenco: calls 1200
cowbicha: folds 
MegadethChug: folds 
wesley18sant has returned
dioclecio13: raises 320 to 1520 and is all-in
Axxxidental: folds 
flagao: folds 
jamaralnt: calls 320
alebitenco: calls 320
*** FLOP *** [As 4d 3c]
jamaralnt: bets 2400
alebitenco: folds 
Uncalled bet (2400) returned to jamaralnt
*** TURN *** [As 4d 3c] [Jd]
*** RIVER *** [As 4d 3c Jd] [4c]
*** SHOW DOWN ***
jamaralnt: shows [5d Ad] (two pair, Aces and Fours)
dioclecio13: shows [Ah Jc] (two pair, Aces and Jacks)
dioclecio13 collected 5860 from pot
*** SUMMARY ***
Total pot 5860 | Rake 0 
Board [As 4d 3c Jd 4c]
Seat 1: MegadethChug folded before Flop (didn't bet)
Seat 2: dioclecio13 (button) showed [Ah Jc] and won (5860) with two pair, Aces and Jacks
Seat 3: Axxxidental (small blind) folded before Flop
Seat 4: flagao (big blind) folded before Flop
Seat 5: jamaralnt showed [5d Ad] and lost with two pair, Aces and Fours
Seat 6: wesley18sant folded before Flop (didn't bet)
Seat 7: alebitenco folded on the Flop
Seat 9: cowbicha folded before Flop (didn't bet)



PokerStars Hand #189313164950: Tournament #2369778109, $0.23+$0.02 USD Hold'em No Limit - Level X (300/600) - 2018/07/29 21:51:16 ET
Table '2369778109 3' 9-max Seat #3 is the button
Seat 1: MegadethChug (6112 in chips) 
Seat 2: dioclecio13 (5860 in chips) 
Seat 3: Axxxidental (5088 in chips) 
Seat 4: flagao (12158 in chips) 
Seat 5: jamaralnt (16323 in chips) 
Seat 6: wesley18sant (3227 in chips) 
Seat 7: alebitenco (12102 in chips) 
Seat 9: cowbicha (6630 in chips) 
MegadethChug: posts the ante 50
dioclecio13: posts the ante 50
Axxxidental: posts the ante 50
flagao: posts the ante 50
jamaralnt: posts the ante 50
wesley18sant: posts the ante 50
alebitenco: posts the ante 50
cowbicha: posts the ante 50
flagao: posts small blind 300
jamaralnt: posts big blind 600
*** HOLE CARDS ***
Dealt to flagao [Qc Jc]
wesley18sant: folds 
alebitenco: folds 
cowbicha: folds 
MegadethChug: folds 
dioclecio13: folds 
Axxxidental: folds 
flagao: raises 600 to 1200
jamaralnt: folds 
Uncalled bet (600) returned to flagao
flagao collected 1600 from pot
flagao: doesn't show hand 
*** SUMMARY ***
Total pot 1600 | Rake 0 
Seat 1: MegadethChug folded before Flop (didn't bet)
Seat 2: dioclecio13 folded before Flop (didn't bet)
Seat 3: Axxxidental (button) folded before Flop (didn't bet)
Seat 4: flagao (small blind) collected (1600)
Seat 5: jamaralnt (big blind) folded before Flop
Seat 6: wesley18sant folded before Flop (didn't bet)
Seat 7: alebitenco folded before Flop (didn't bet)
Seat 9: cowbicha folded before Flop (didn't bet)



PokerStars Hand #189313172729: Tournament #2369778109, $0.23+$0.02 USD Hold'em No Limit - Level X (300/600) - 2018/07/29 21:51:39 ET
Table '2369778109 3' 9-max Seat #4 is the button
Seat 1: MegadethChug (6062 in chips) 
Seat 2: dioclecio13 (5810 in chips) 
Seat 3: Axxxidental (5038 in chips) 
Seat 4: flagao (13108 in chips) 
Seat 5: jamaralnt (15673 in chips) 
Seat 6: wesley18sant (3177 in chips) 
Seat 7: alebitenco (12052 in chips) 
Seat 9: cowbicha (6580 in chips) 
MegadethChug: posts the ante 50
dioclecio13: posts the ante 50
Axxxidental: posts the ante 50
flagao: posts the ante 50
jamaralnt: posts the ante 50
wesley18sant: posts the ante 50
alebitenco: posts the ante 50
cowbicha: posts the ante 50
jamaralnt: posts small blind 300
wesley18sant: posts big blind 600
*** HOLE CARDS ***
Dealt to flagao [3d Ah]
alebitenco: folds 
cowbicha: folds 
MegadethChug: folds 
dioclecio13: folds 
Axxxidental: folds 
flagao: raises 600 to 1200
jamaralnt: folds 
wesley18sant: folds 
Uncalled bet (600) returned to flagao
flagao collected 1900 from pot
flagao: doesn't show hand 
*** SUMMARY ***
Total pot 1900 | Rake 0 
Seat 1: MegadethChug folded before Flop (didn't bet)
Seat 2: dioclecio13 folded before Flop (didn't bet)
Seat 3: Axxxidental folded before Flop (didn't bet)
Seat 4: flagao (button) collected (1900)
Seat 5: jamaralnt (small blind) folded before Flop
Seat 6: wesley18sant (big blind) folded before Flop
Seat 7: alebitenco folded before Flop (didn't bet)
Seat 9: cowbicha folded before Flop (didn't bet)



PokerStars Hand #189313180540: Tournament #2369778109, $0.23+$0.02 USD Hold'em No Limit - Level X (300/600) - 2018/07/29 21:52:02 ET
Table '2369778109 3' 9-max Seat #5 is the button
Seat 1: MegadethChug (6012 in chips) 
Seat 2: dioclecio13 (5760 in chips) 
Seat 3: Axxxidental (4988 in chips) 
Seat 4: flagao (14358 in chips) 
Seat 5: jamaralnt (15323 in chips) 
Seat 6: wesley18sant (2527 in chips) 
Seat 7: alebitenco (12002 in chips) 
Seat 9: cowbicha (6530 in chips) 
MegadethChug: posts the ante 50
dioclecio13: posts the ante 50
Axxxidental: posts the ante 50
flagao: posts the ante 50
jamaralnt: posts the ante 50
wesley18sant: posts the ante 50
alebitenco: posts the ante 50
cowbicha: posts the ante 50
wesley18sant: posts small blind 300
alebitenco: posts big blind 600
*** HOLE CARDS ***
Dealt to flagao [2h 6d]
cowbicha: raises 5880 to 6480 and is all-in
MegadethChug: folds 
dioclecio13: folds 
Axxxidental: folds 
flagao: folds 
jamaralnt: folds 
wesley18sant: folds 
alebitenco: folds 
Uncalled bet (5880) returned to cowbicha
cowbicha collected 1900 from pot
*** SUMMARY ***
Total pot 1900 | Rake 0 
Seat 1: MegadethChug folded before Flop (didn't bet)
Seat 2: dioclecio13 folded before Flop (didn't bet)
Seat 3: Axxxidental folded before Flop (didn't bet)
Seat 4: flagao folded before Flop (didn't bet)
Seat 5: jamaralnt (button) folded before Flop (didn't bet)
Seat 6: wesley18sant (small blind) folded before Flop
Seat 7: alebitenco (big blind) folded before Flop
Seat 9: cowbicha collected (1900)



PokerStars Hand #189313185716: Tournament #2369778109, $0.23+$0.02 USD Hold'em No Limit - Level X (300/600) - 2018/07/29 21:52:18 ET
Table '2369778109 3' 9-max Seat #6 is the button
Seat 1: MegadethChug (5962 in chips) 
Seat 2: dioclecio13 (5710 in chips) 
Seat 3: Axxxidental (4938 in chips) 
Seat 4: flagao (14308 in chips) 
Seat 5: jamaralnt (15273 in chips) 
Seat 6: wesley18sant (2177 in chips) 
Seat 7: alebitenco (11352 in chips) 
Seat 9: cowbicha (7780 in chips) 
MegadethChug: posts the ante 50
dioclecio13: posts the ante 50
Axxxidental: posts the ante 50
flagao: posts the ante 50
jamaralnt: posts the ante 50
wesley18sant: posts the ante 50
alebitenco: posts the ante 50
cowbicha: posts the ante 50
alebitenco: posts small blind 300
cowbicha: posts big blind 600
*** HOLE CARDS ***
Dealt to flagao [Th 6d]
MegadethChug: folds 
dioclecio13: folds 
Axxxidental: folds 
flagao: folds 
jamaralnt: raises 600 to 1200
wesley18sant: raises 927 to 2127 and is all-in
alebitenco: folds 
cowbicha: folds 
jamaralnt: calls 927
*** FLOP *** [9s Js Kh]
*** TURN *** [9s Js Kh] [Kc]
*** RIVER *** [9s Js Kh Kc] [9d]
*** SHOW DOWN ***
jamaralnt: shows [Qc 2d] (two pair, Kings and Nines)
wesley18sant: shows [Qd 7d] (two pair, Kings and Nines)
jamaralnt collected 2777 from pot
wesley18sant collected 2777 from pot
*** SUMMARY ***
Total pot 5554 | Rake 0 
Board [9s Js Kh Kc 9d]
Seat 1: MegadethChug folded before Flop (didn't bet)
Seat 2: dioclecio13 folded before Flop (didn't bet)
Seat 3: Axxxidental folded before Flop (didn't bet)
Seat 4: flagao folded before Flop (didn't bet)
Seat 5: jamaralnt showed [Qc 2d] and won (2777) with two pair, Kings and Nines
Seat 6: wesley18sant (button) showed [Qd 7d] and won (2777) with two pair, Kings and Nines
Seat 7: alebitenco (small blind) folded before Flop
Seat 9: cowbicha (big blind) folded before Flop



PokerStars Hand #189313196124: Tournament #2369778109, $0.23+$0.02 USD Hold'em No Limit - Level X (300/600) - 2018/07/29 21:52:49 ET
Table '2369778109 3' 9-max Seat #7 is the button
Seat 1: MegadethChug (5912 in chips) 
Seat 2: dioclecio13 (5660 in chips) 
Seat 3: Axxxidental (4888 in chips) 
Seat 4: flagao (14258 in chips) 
Seat 5: jamaralnt (15873 in chips) 
Seat 6: wesley18sant (2777 in chips) 
Seat 7: alebitenco (11002 in chips) 
Seat 9: cowbicha (7130 in chips) 
MegadethChug: posts the ante 50
dioclecio13: posts the ante 50
Axxxidental: posts the ante 50
flagao: posts the ante 50
jamaralnt: posts the ante 50
wesley18sant: posts the ante 50
alebitenco: posts the ante 50
cowbicha: posts the ante 50
cowbicha: posts small blind 300
MegadethChug: posts big blind 600
*** HOLE CARDS ***
Dealt to flagao [2s Qs]
dioclecio13: folds 
Axxxidental: folds 
flagao: folds 
jamaralnt: folds 
wesley18sant: folds 
alebitenco: folds 
cowbicha: raises 600 to 1200
MegadethChug: folds 
Uncalled bet (600) returned to cowbicha
cowbicha collected 1600 from pot
*** SUMMARY ***
Total pot 1600 | Rake 0 
Seat 1: MegadethChug (big blind) folded before Flop
Seat 2: dioclecio13 folded before Flop (didn't bet)
Seat 3: Axxxidental folded before Flop (didn't bet)
Seat 4: flagao folded before Flop (didn't bet)
Seat 5: jamaralnt folded before Flop (didn't bet)
Seat 6: wesley18sant folded before Flop (didn't bet)
Seat 7: alebitenco (button) folded before Flop (didn't bet)
Seat 9: cowbicha (small blind) collected (1600)



PokerStars Hand #189313207334: Tournament #2369778109, $0.23+$0.02 USD Hold'em No Limit - Level X (300/600) - 2018/07/29 21:53:23 ET
Table '2369778109 3' 9-max Seat #9 is the button
Seat 1: MegadethChug (5262 in chips) 
Seat 2: dioclecio13 (5610 in chips) 
Seat 3: Axxxidental (4838 in chips) 
Seat 4: flagao (14208 in chips) 
Seat 5: jamaralnt (15823 in chips) 
Seat 6: wesley18sant (2727 in chips) 
Seat 7: alebitenco (10952 in chips) 
Seat 9: cowbicha (8080 in chips) 
MegadethChug: posts the ante 50
dioclecio13: posts the ante 50
Axxxidental: posts the ante 50
flagao: posts the ante 50
jamaralnt: posts the ante 50
wesley18sant: posts the ante 50
alebitenco: posts the ante 50
cowbicha: posts the ante 50
MegadethChug: posts small blind 300
dioclecio13: posts big blind 600
*** HOLE CARDS ***
Dealt to flagao [8d 6h]
Axxxidental: folds 
flagao: folds 
jamaralnt: raises 600 to 1200
wesley18sant: folds 
alebitenco: folds 
cowbicha: folds 
MegadethChug: folds 
dioclecio13: calls 600
*** FLOP *** [9c Jh 9d]
dioclecio13: checks 
jamaralnt: bets 1800
dioclecio13: raises 2560 to 4360 and is all-in
jamaralnt: calls 2560
*** TURN *** [9c Jh 9d] [2c]
*** RIVER *** [9c Jh 9d 2c] [8h]
*** SHOW DOWN ***
dioclecio13: shows [Tc Qc] (a straight, Eight to Queen)
jamaralnt: shows [7c 8c] (two pair, Nines and Eights)
dioclecio13 collected 11820 from pot
*** SUMMARY ***
Total pot 11820 | Rake 0 
Board [9c Jh 9d 2c 8h]
Seat 1: MegadethChug (small blind) folded before Flop
Seat 2: dioclecio13 (big blind) showed [Tc Qc] and won (11820) with a straight, Eight to Queen
Seat 3: Axxxidental folded before Flop (didn't bet)
Seat 4: flagao folded before Flop (didn't bet)
Seat 5: jamaralnt showed [7c 8c] and lost with two pair, Nines and Eights
Seat 6: wesley18sant folded before Flop (didn't bet)
Seat 7: alebitenco folded before Flop (didn't bet)
Seat 9: cowbicha (button) folded before Flop (didn't bet)



PokerStars Hand #189313222238: Tournament #2369778109, $0.23+$0.02 USD Hold'em No Limit - Level X (300/600) - 2018/07/29 21:54:08 ET
Table '2369778109 3' 9-max Seat #1 is the button
Seat 1: MegadethChug (4912 in chips) 
Seat 2: dioclecio13 (11820 in chips) 
Seat 3: Axxxidental (4788 in chips) 
Seat 4: flagao (14158 in chips) 
Seat 5: jamaralnt (10213 in chips) 
Seat 6: wesley18sant (2677 in chips) 
Seat 7: alebitenco (10902 in chips) 
Seat 9: cowbicha (8030 in chips) 
MegadethChug: posts the ante 50
dioclecio13: posts the ante 50
Axxxidental: posts the ante 50
flagao: posts the ante 50
jamaralnt: posts the ante 50
wesley18sant: posts the ante 50
alebitenco: posts the ante 50
cowbicha: posts the ante 50
dioclecio13: posts small blind 300
Axxxidental: posts big blind 600
*** HOLE CARDS ***
Dealt to flagao [6s Kh]
flagao: folds 
jamaralnt: folds 
wesley18sant: raises 2027 to 2627 and is all-in
alebitenco: folds 
cowbicha: folds 
MegadethChug: folds 
dioclecio13: raises 9143 to 11770 and is all-in
Axxxidental: folds 
Uncalled bet (9143) returned to dioclecio13
*** FLOP *** [6h Ts Qd]
*** TURN *** [6h Ts Qd] [4s]
*** RIVER *** [6h Ts Qd 4s] [Kc]
*** SHOW DOWN ***
dioclecio13: shows [Th Td] (three of a kind, Tens)
wesley18sant: shows [Ac 9c] (high card Ace)
dioclecio13 collected 6254 from pot
wesley18sant finished the tournament in 8th place
*** SUMMARY ***
Total pot 6254 | Rake 0 
Board [6h Ts Qd 4s Kc]
Seat 1: MegadethChug (button) folded before Flop (didn't bet)
Seat 2: dioclecio13 (small blind) showed [Th Td] and won (6254) with three of a kind, Tens
Seat 3: Axxxidental (big blind) folded before Flop
Seat 4: flagao folded before Flop (didn't bet)
Seat 5: jamaralnt folded before Flop (didn't bet)
Seat 6: wesley18sant showed [Ac 9c] and lost with high card Ace
Seat 7: alebitenco folded before Flop (didn't bet)
Seat 9: cowbicha folded before Flop (didn't bet)



PokerStars Hand #189313231868: Tournament #2369778109, $0.23+$0.02 USD Hold'em No Limit - Level X (300/600) - 2018/07/29 21:54:37 ET
Table '2369778109 3' 9-max Seat #2 is the button
Seat 1: MegadethChug (4862 in chips) 
Seat 2: dioclecio13 (15397 in chips) 
Seat 3: Axxxidental (4138 in chips) 
Seat 4: flagao (14108 in chips) 
Seat 5: jamaralnt (10163 in chips) 
Seat 7: alebitenco (10852 in chips) 
Seat 9: cowbicha (7980 in chips) 
MegadethChug: posts the ante 50
dioclecio13: posts the ante 50
Axxxidental: posts the ante 50
flagao: posts the ante 50
jamaralnt: posts the ante 50
alebitenco: posts the ante 50
cowbicha: posts the ante 50
Axxxidental: posts small blind 300
flagao: posts big blind 600
*** HOLE CARDS ***
Dealt to flagao [6c 9h]
jamaralnt: folds 
alebitenco: folds 
cowbicha: folds 
MegadethChug: folds 
dioclecio13: folds 
Axxxidental: raises 3474 to 4074
flagao: folds 
Uncalled bet (3474) returned to Axxxidental
Axxxidental collected 1550 from pot
*** SUMMARY ***
Total pot 1550 | Rake 0 
Seat 1: MegadethChug folded before Flop (didn't bet)
Seat 2: dioclecio13 (button) folded before Flop (didn't bet)
Seat 3: Axxxidental (small blind) collected (1550)
Seat 4: flagao (big blind) folded before Flop
Seat 5: jamaralnt folded before Flop (didn't bet)
Seat 7: alebitenco folded before Flop (didn't bet)
Seat 9: cowbicha folded before Flop (didn't bet)



PokerStars Hand #189313323978: Tournament #2369778109, $0.23+$0.02 USD Hold'em No Limit - Level X (300/600) - 2018/07/29 22:00:06 ET
Table '2369778109 3' 9-max Seat #3 is the button
Seat 1: MegadethChug (4812 in chips) 
Seat 2: dioclecio13 (15347 in chips) 
Seat 3: Axxxidental (5038 in chips) 
Seat 4: flagao (13458 in chips) 
Seat 5: jamaralnt (10113 in chips) 
Seat 7: alebitenco (10802 in chips) 
Seat 9: cowbicha (7930 in chips) 
MegadethChug: posts the ante 50
dioclecio13: posts the ante 50
Axxxidental: posts the ante 50
flagao: posts the ante 50
jamaralnt: posts the ante 50
alebitenco: posts the ante 50
cowbicha: posts the ante 50
flagao: posts small blind 300
jamaralnt: posts big blind 600
*** HOLE CARDS ***
Dealt to flagao [2h 5h]
alebitenco: folds 
cowbicha: folds 
MegadethChug: folds 
dioclecio13: raises 600 to 1200
Axxxidental: folds 
flagao: folds 
jamaralnt: raises 1800 to 3000
dioclecio13: raises 12297 to 15297 and is all-in
jamaralnt: calls 7063 and is all-in
Uncalled bet (5234) returned to dioclecio13
*** FLOP *** [5d 6s 9s]
*** TURN *** [5d 6s 9s] [5s]
*** RIVER *** [5d 6s 9s 5s] [Ac]
*** SHOW DOWN ***
jamaralnt: shows [6c 8c] (two pair, Sixes and Fives)
dioclecio13: shows [Kd Ah] (two pair, Aces and Fives)
dioclecio13 collected 20776 from pot
jamaralnt finished the tournament in 7th place and received $0.36.
*** SUMMARY ***
Total pot 20776 | Rake 0 
Board [5d 6s 9s 5s Ac]
Seat 1: MegadethChug folded before Flop (didn't bet)
Seat 2: dioclecio13 showed [Kd Ah] and won (20776) with two pair, Aces and Fives
Seat 3: Axxxidental (button) folded before Flop (didn't bet)
Seat 4: flagao (small blind) folded before Flop
Seat 5: jamaralnt (big blind) showed [6c 8c] and lost with two pair, Sixes and Fives
Seat 7: alebitenco folded before Flop (didn't bet)
Seat 9: cowbicha folded before Flop (didn't bet)



PokerStars Hand #189313351352: Tournament #2369778109, $0.23+$0.02 USD Hold'em No Limit - Level X (300/600) - 2018/07/29 22:01:37 ET
Table '2369778109 3' 9-max Seat #4 is the button
Seat 1: MegadethChug (4762 in chips) 
Seat 2: dioclecio13 (26010 in chips) 
Seat 3: Axxxidental (4988 in chips) 
Seat 4: flagao (13108 in chips) 
Seat 7: alebitenco (10752 in chips) 
Seat 9: cowbicha (7880 in chips) 
MegadethChug: posts the ante 50
dioclecio13: posts the ante 50
Axxxidental: posts the ante 50
flagao: posts the ante 50
alebitenco: posts the ante 50
cowbicha: posts the ante 50
alebitenco: posts small blind 300
cowbicha: posts big blind 600
*** HOLE CARDS ***
Dealt to flagao [7d 2s]
cowbicha said, "lol"
MegadethChug: folds 
dioclecio13: raises 25360 to 25960 and is all-in
Axxxidental: folds 
flagao: folds 
alebitenco: folds 
cowbicha: folds 
Uncalled bet (25360) returned to dioclecio13
dioclecio13 collected 1800 from pot
dioclecio13: doesn't show hand 
*** SUMMARY ***
Total pot 1800 | Rake 0 
Seat 1: MegadethChug folded before Flop (didn't bet)
Seat 2: dioclecio13 collected (1800)
Seat 3: Axxxidental folded before Flop (didn't bet)
Seat 4: flagao (button) folded before Flop (didn't bet)
Seat 7: alebitenco (small blind) folded before Flop
Seat 9: cowbicha (big blind) folded before Flop



PokerStars Hand #189313358194: Tournament #2369778109, $0.23+$0.02 USD Hold'em No Limit - Level X (300/600) - 2018/07/29 22:01:59 ET
Table '2369778109 3' 9-max Seat #7 is the button
Seat 1: MegadethChug (4712 in chips) 
Seat 2: dioclecio13 (27160 in chips) 
Seat 3: Axxxidental (4938 in chips) 
Seat 4: flagao (13058 in chips) 
Seat 7: alebitenco (10402 in chips) 
Seat 9: cowbicha (7230 in chips) 
MegadethChug: posts the ante 50
dioclecio13: posts the ante 50
Axxxidental: posts the ante 50
flagao: posts the ante 50
alebitenco: posts the ante 50
cowbicha: posts the ante 50
cowbicha: posts small blind 300
MegadethChug: posts big blind 600
*** HOLE CARDS ***
Dealt to flagao [Kc Ad]
dioclecio13: raises 600 to 1200
Axxxidental: folds 
flagao: raises 2400 to 3600
alebitenco: folds 
cowbicha: folds 
MegadethChug: folds 
dioclecio13: calls 2400
*** FLOP *** [Ah Ks 7h]
dioclecio13: checks 
flagao: bets 4800
dioclecio13: folds 
Uncalled bet (4800) returned to flagao
flagao collected 8400 from pot
flagao: doesn't show hand 
*** SUMMARY ***
Total pot 8400 | Rake 0 
Board [Ah Ks 7h]
Seat 1: MegadethChug (big blind) folded before Flop
Seat 2: dioclecio13 folded on the Flop
Seat 3: Axxxidental folded before Flop (didn't bet)
Seat 4: flagao collected (8400)
Seat 7: alebitenco (button) folded before Flop (didn't bet)
Seat 9: cowbicha (small blind) folded before Flop



PokerStars Hand #189313371226: Tournament #2369778109, $0.23+$0.02 USD Hold'em No Limit - Level XI (400/800) - 2018/07/29 22:02:39 ET
Table '2369778109 3' 9-max Seat #9 is the button
Seat 1: MegadethChug (4062 in chips) 
Seat 2: dioclecio13 (23510 in chips) 
Seat 3: Axxxidental (4888 in chips) 
Seat 4: flagao (17808 in chips) 
Seat 7: alebitenco (10352 in chips) 
Seat 9: cowbicha (6880 in chips) 
MegadethChug: posts the ante 50
dioclecio13: posts the ante 50
Axxxidental: posts the ante 50
flagao: posts the ante 50
alebitenco: posts the ante 50
cowbicha: posts the ante 50
MegadethChug: posts small blind 400
dioclecio13: posts big blind 800
*** HOLE CARDS ***
Dealt to flagao [Js 7s]
Axxxidental: folds 
flagao: folds 
alebitenco: folds 
cowbicha: folds 
MegadethChug: raises 3212 to 4012 and is all-in
dioclecio13: calls 3212
*** FLOP *** [3d Qs 4h]
*** TURN *** [3d Qs 4h] [Th]
*** RIVER *** [3d Qs 4h Th] [3s]
*** SHOW DOWN ***
MegadethChug: shows [Ts Kc] (two pair, Tens and Threes)
dioclecio13: shows [As 8h] (a pair of Threes)
MegadethChug collected 8324 from pot
*** SUMMARY ***
Total pot 8324 | Rake 0 
Board [3d Qs 4h Th 3s]
Seat 1: MegadethChug (small blind) showed [Ts Kc] and won (8324) with two pair, Tens and Threes
Seat 2: dioclecio13 (big blind) showed [As 8h] and lost with a pair of Threes
Seat 3: Axxxidental folded before Flop (didn't bet)
Seat 4: flagao folded before Flop (didn't bet)
Seat 7: alebitenco folded before Flop (didn't bet)
Seat 9: cowbicha (button) folded before Flop (didn't bet)



PokerStars Hand #189313381199: Tournament #2369778109, $0.23+$0.02 USD Hold'em No Limit - Level XI (400/800) - 2018/07/29 22:03:10 ET
Table '2369778109 3' 9-max Seat #1 is the button
Seat 1: MegadethChug (8324 in chips) 
Seat 2: dioclecio13 (19448 in chips) 
Seat 3: Axxxidental (4838 in chips) 
Seat 4: flagao (17758 in chips) 
Seat 7: alebitenco (10302 in chips) 
Seat 9: cowbicha (6830 in chips) 
MegadethChug: posts the ante 50
dioclecio13: posts the ante 50
Axxxidental: posts the ante 50
flagao: posts the ante 50
alebitenco: posts the ante 50
cowbicha: posts the ante 50
dioclecio13: posts small blind 400
Axxxidental: posts big blind 800
*** HOLE CARDS ***
Dealt to flagao [Ah 9s]
flagao: raises 800 to 1600
alebitenco: folds 
cowbicha: folds 
MegadethChug: folds 
dioclecio13: folds 
Axxxidental: folds 
Uncalled bet (800) returned to flagao
flagao collected 2300 from pot
flagao: doesn't show hand 
*** SUMMARY ***
Total pot 2300 | Rake 0 
Seat 1: MegadethChug (button) folded before Flop (didn't bet)
Seat 2: dioclecio13 (small blind) folded before Flop
Seat 3: Axxxidental (big blind) folded before Flop
Seat 4: flagao collected (2300)
Seat 7: alebitenco folded before Flop (didn't bet)
Seat 9: cowbicha folded before Flop (didn't bet)



PokerStars Hand #189313388509: Tournament #2369778109, $0.23+$0.02 USD Hold'em No Limit - Level XI (400/800) - 2018/07/29 22:03:33 ET
Table '2369778109 3' 9-max Seat #2 is the button
Seat 1: MegadethChug (8274 in chips) 
Seat 2: dioclecio13 (18998 in chips) 
Seat 3: Axxxidental (3988 in chips) 
Seat 4: flagao (19208 in chips) 
Seat 7: alebitenco (10252 in chips) 
Seat 9: cowbicha (6780 in chips) 
MegadethChug: posts the ante 50
dioclecio13: posts the ante 50
Axxxidental: posts the ante 50
flagao: posts the ante 50
alebitenco: posts the ante 50
cowbicha: posts the ante 50
Axxxidental: posts small blind 400
flagao: posts big blind 800
*** HOLE CARDS ***
Dealt to flagao [8s 6d]
alebitenco: folds 
cowbicha: folds 
MegadethChug: folds 
dioclecio13: folds 
Axxxidental: folds 
Uncalled bet (400) returned to flagao
flagao collected 1100 from pot
flagao: doesn't show hand 
*** SUMMARY ***
Total pot 1100 | Rake 0 
Seat 1: MegadethChug folded before Flop (didn't bet)
Seat 2: dioclecio13 (button) folded before Flop (didn't bet)
Seat 3: Axxxidental (small blind) folded before Flop
Seat 4: flagao (big blind) collected (1100)
Seat 7: alebitenco folded before Flop (didn't bet)
Seat 9: cowbicha folded before Flop (didn't bet)



PokerStars Hand #189313393840: Tournament #2369778109, $0.23+$0.02 USD Hold'em No Limit - Level XI (400/800) - 2018/07/29 22:03:50 ET
Table '2369778109 3' 9-max Seat #3 is the button
Seat 1: MegadethChug (8224 in chips) 
Seat 2: dioclecio13 (18948 in chips) 
Seat 3: Axxxidental (3538 in chips) 
Seat 4: flagao (19858 in chips) 
Seat 7: alebitenco (10202 in chips) 
Seat 9: cowbicha (6730 in chips) 
MegadethChug: posts the ante 50
dioclecio13: posts the ante 50
Axxxidental: posts the ante 50
flagao: posts the ante 50
alebitenco: posts the ante 50
cowbicha: posts the ante 50
flagao: posts small blind 400
alebitenco: posts big blind 800
*** HOLE CARDS ***
Dealt to flagao [Jh Jd]
cowbicha: raises 5880 to 6680 and is all-in
MegadethChug: folds 
dioclecio13: folds 
Axxxidental: folds 
flagao: raises 5880 to 12560
alebitenco: folds 
Uncalled bet (5880) returned to flagao
*** FLOP *** [4d 3d 9d]
*** TURN *** [4d 3d 9d] [6s]
*** RIVER *** [4d 3d 9d 6s] [4h]
*** SHOW DOWN ***
flagao: shows [Jh Jd] (two pair, Jacks and Fours)
cowbicha: shows [8c 7s] (a pair of Fours)
flagao collected 14460 from pot
cowbicha finished the tournament in 6th place and received $0.62.
*** SUMMARY ***
Total pot 14460 | Rake 0 
Board [4d 3d 9d 6s 4h]
Seat 1: MegadethChug folded before Flop (didn't bet)
Seat 2: dioclecio13 folded before Flop (didn't bet)
Seat 3: Axxxidental (button) folded before Flop (didn't bet)
Seat 4: flagao (small blind) showed [Jh Jd] and won (14460) with two pair, Jacks and Fours
Seat 7: alebitenco (big blind) folded before Flop
Seat 9: cowbicha showed [8c 7s] and lost with a pair of Fours



PokerStars Hand #189313402625: Tournament #2369778109, $0.23+$0.02 USD Hold'em No Limit - Level XI (400/800) - 2018/07/29 22:04:17 ET
Table '2369778109 3' 9-max Seat #4 is the button
Seat 1: MegadethChug (8174 in chips) 
Seat 2: dioclecio13 (18898 in chips) 
Seat 3: Axxxidental (3488 in chips) 
Seat 4: flagao (27588 in chips) 
Seat 7: alebitenco (9352 in chips) 
MegadethChug: posts the ante 50
dioclecio13: posts the ante 50
Axxxidental: posts the ante 50
flagao: posts the ante 50
alebitenco: posts the ante 50
alebitenco: posts small blind 400
MegadethChug: posts big blind 800
*** HOLE CARDS ***
Dealt to flagao [3d 7h]
dioclecio13: folds 
Axxxidental: folds 
flagao: folds 
alebitenco: raises 800 to 1600
MegadethChug: calls 800
*** FLOP *** [Kh 4s Qh]
alebitenco: checks 
MegadethChug: checks 
*** TURN *** [Kh 4s Qh] [8s]
alebitenco: checks 
MegadethChug: checks 
*** RIVER *** [Kh 4s Qh 8s] [6h]
alebitenco: checks 
MegadethChug: checks 
*** SHOW DOWN ***
alebitenco: shows [Ah 2d] (high card Ace)
MegadethChug: mucks hand 
alebitenco collected 3450 from pot
*** SUMMARY ***
Total pot 3450 | Rake 0 
Board [Kh 4s Qh 8s 6h]
Seat 1: MegadethChug (big blind) mucked [Th Js]
Seat 2: dioclecio13 folded before Flop (didn't bet)
Seat 3: Axxxidental folded before Flop (didn't bet)
Seat 4: flagao (button) folded before Flop (didn't bet)
Seat 7: alebitenco (small blind) showed [Ah 2d] and won (3450) with high card Ace



PokerStars Hand #189313413980: Tournament #2369778109, $0.23+$0.02 USD Hold'em No Limit - Level XI (400/800) - 2018/07/29 22:04:52 ET
Table '2369778109 3' 9-max Seat #7 is the button
Seat 1: MegadethChug (6524 in chips) 
Seat 2: dioclecio13 (18848 in chips) 
Seat 3: Axxxidental (3438 in chips) 
Seat 4: flagao (27538 in chips) 
Seat 7: alebitenco (11152 in chips) 
MegadethChug: posts the ante 50
dioclecio13: posts the ante 50
Axxxidental: posts the ante 50
flagao: posts the ante 50
alebitenco: posts the ante 50
MegadethChug: posts small blind 400
dioclecio13: posts big blind 800
*** HOLE CARDS ***
Dealt to flagao [Qd Ah]
Axxxidental: folds 
flagao: raises 800 to 1600
alebitenco: folds 
MegadethChug: folds 
dioclecio13: folds 
Uncalled bet (800) returned to flagao
flagao collected 2250 from pot
flagao: doesn't show hand 
*** SUMMARY ***
Total pot 2250 | Rake 0 
Seat 1: MegadethChug (small blind) folded before Flop
Seat 2: dioclecio13 (big blind) folded before Flop
Seat 3: Axxxidental folded before Flop (didn't bet)
Seat 4: flagao collected (2250)
Seat 7: alebitenco (button) folded before Flop (didn't bet)



PokerStars Hand #189313420529: Tournament #2369778109, $0.23+$0.02 USD Hold'em No Limit - Level XI (400/800) - 2018/07/29 22:05:13 ET
Table '2369778109 3' 9-max Seat #1 is the button
Seat 1: MegadethChug (6074 in chips) 
Seat 2: dioclecio13 (17998 in chips) 
Seat 3: Axxxidental (3388 in chips) 
Seat 4: flagao (28938 in chips) 
Seat 7: alebitenco (11102 in chips) 
MegadethChug: posts the ante 50
dioclecio13: posts the ante 50
Axxxidental: posts the ante 50
flagao: posts the ante 50
alebitenco: posts the ante 50
dioclecio13: posts small blind 400
Axxxidental: posts big blind 800
*** HOLE CARDS ***
Dealt to flagao [8h 9c]
flagao: folds 
alebitenco: folds 
MegadethChug: folds 
dioclecio13: raises 17148 to 17948 and is all-in
Axxxidental: folds 
Uncalled bet (17148) returned to dioclecio13
dioclecio13 collected 1850 from pot
dioclecio13: doesn't show hand 
*** SUMMARY ***
Total pot 1850 | Rake 0 
Seat 1: MegadethChug (button) folded before Flop (didn't bet)
Seat 2: dioclecio13 (small blind) collected (1850)
Seat 3: Axxxidental (big blind) folded before Flop
Seat 4: flagao folded before Flop (didn't bet)
Seat 7: alebitenco folded before Flop (didn't bet)



PokerStars Hand #189313428870: Tournament #2369778109, $0.23+$0.02 USD Hold'em No Limit - Level XI (400/800) - 2018/07/29 22:05:38 ET
Table '2369778109 3' 9-max Seat #2 is the button
Seat 1: MegadethChug (6024 in chips) 
Seat 2: dioclecio13 (18998 in chips) 
Seat 3: Axxxidental (2538 in chips) 
Seat 4: flagao (28888 in chips) 
Seat 7: alebitenco (11052 in chips) 
MegadethChug: posts the ante 50
dioclecio13: posts the ante 50
Axxxidental: posts the ante 50
flagao: posts the ante 50
alebitenco: posts the ante 50
Axxxidental: posts small blind 400
flagao: posts big blind 800
*** HOLE CARDS ***
Dealt to flagao [Qc 2c]
alebitenco: folds 
MegadethChug: folds 
dioclecio13: folds 
Axxxidental: raises 1688 to 2488 and is all-in
flagao: folds 
Uncalled bet (1688) returned to Axxxidental
Axxxidental collected 1850 from pot
*** SUMMARY ***
Total pot 1850 | Rake 0 
Seat 1: MegadethChug folded before Flop (didn't bet)
Seat 2: dioclecio13 (button) folded before Flop (didn't bet)
Seat 3: Axxxidental (small blind) collected (1850)
Seat 4: flagao (big blind) folded before Flop
Seat 7: alebitenco folded before Flop (didn't bet)



PokerStars Hand #189313437557: Tournament #2369778109, $0.23+$0.02 USD Hold'em No Limit - Level XI (400/800) - 2018/07/29 22:06:05 ET
Table '2369778109 3' 9-max Seat #3 is the button
Seat 1: MegadethChug (5974 in chips) 
Seat 2: dioclecio13 (18948 in chips) 
Seat 3: Axxxidental (3538 in chips) 
Seat 4: flagao (28038 in chips) 
Seat 7: alebitenco (11002 in chips) 
MegadethChug: posts the ante 50
dioclecio13: posts the ante 50
Axxxidental: posts the ante 50
flagao: posts the ante 50
alebitenco: posts the ante 50
flagao: posts small blind 400
alebitenco: posts big blind 800
*** HOLE CARDS ***
Dealt to flagao [3s Jc]
MegadethChug: folds 
dioclecio13: folds 
Axxxidental: raises 2688 to 3488 and is all-in
flagao: folds 
alebitenco: folds 
Uncalled bet (2688) returned to Axxxidental
Axxxidental collected 2250 from pot
*** SUMMARY ***
Total pot 2250 | Rake 0 
Seat 1: MegadethChug folded before Flop (didn't bet)
Seat 2: dioclecio13 folded before Flop (didn't bet)
Seat 3: Axxxidental (button) collected (2250)
Seat 4: flagao (small blind) folded before Flop
Seat 7: alebitenco (big blind) folded before Flop



PokerStars Hand #189313444572: Tournament #2369778109, $0.23+$0.02 USD Hold'em No Limit - Level XI (400/800) - 2018/07/29 22:06:27 ET
Table '2369778109 3' 9-max Seat #4 is the button
Seat 1: MegadethChug (5924 in chips) 
Seat 2: dioclecio13 (18898 in chips) 
Seat 3: Axxxidental (4938 in chips) 
Seat 4: flagao (27588 in chips) 
Seat 7: alebitenco (10152 in chips) 
MegadethChug: posts the ante 50
dioclecio13: posts the ante 50
Axxxidental: posts the ante 50
flagao: posts the ante 50
alebitenco: posts the ante 50
alebitenco: posts small blind 400
MegadethChug: posts big blind 800
*** HOLE CARDS ***
Dealt to flagao [7h 2c]
dioclecio13: folds 
Axxxidental: raises 4088 to 4888 and is all-in
flagao: folds 
alebitenco: folds 
MegadethChug: calls 4088
*** FLOP *** [6c 2s 4d]
*** TURN *** [6c 2s 4d] [3d]
*** RIVER *** [6c 2s 4d 3d] [Jc]
*** SHOW DOWN ***
MegadethChug: shows [9c 9s] (a pair of Nines)
Axxxidental: shows [Js Ks] (a pair of Jacks)
Axxxidental collected 10426 from pot
*** SUMMARY ***
Total pot 10426 | Rake 0 
Board [6c 2s 4d 3d Jc]
Seat 1: MegadethChug (big blind) showed [9c 9s] and lost with a pair of Nines
Seat 2: dioclecio13 folded before Flop (didn't bet)
Seat 3: Axxxidental showed [Js Ks] and won (10426) with a pair of Jacks
Seat 4: flagao (button) folded before Flop (didn't bet)
Seat 7: alebitenco (small blind) folded before Flop



PokerStars Hand #189313452560: Tournament #2369778109, $0.23+$0.02 USD Hold'em No Limit - Level XI (400/800) - 2018/07/29 22:06:52 ET
Table '2369778109 3' 9-max Seat #7 is the button
Seat 1: MegadethChug (986 in chips) 
Seat 2: dioclecio13 (18848 in chips) 
Seat 3: Axxxidental (10426 in chips) 
Seat 4: flagao (27538 in chips) 
Seat 7: alebitenco (9702 in chips) 
MegadethChug: posts the ante 50
dioclecio13: posts the ante 50
Axxxidental: posts the ante 50
flagao: posts the ante 50
alebitenco: posts the ante 50
MegadethChug: posts small blind 400
dioclecio13: posts big blind 800
*** HOLE CARDS ***
Dealt to flagao [5s 9c]
Axxxidental: folds 
flagao: folds 
alebitenco: folds 
MegadethChug: raises 136 to 936 and is all-in
dioclecio13: calls 136
*** FLOP *** [Th 9d 7h]
*** TURN *** [Th 9d 7h] [Qs]
*** RIVER *** [Th 9d 7h Qs] [8c]
*** SHOW DOWN ***
MegadethChug: shows [Jd 3s] (a straight, Eight to Queen)
dioclecio13: shows [6s 2d] (a straight, Six to Ten)
MegadethChug collected 2122 from pot
*** SUMMARY ***
Total pot 2122 | Rake 0 
Board [Th 9d 7h Qs 8c]
Seat 1: MegadethChug (small blind) showed [Jd 3s] and won (2122) with a straight, Eight to Queen
Seat 2: dioclecio13 (big blind) showed [6s 2d] and lost with a straight, Six to Ten
Seat 3: Axxxidental folded before Flop (didn't bet)
Seat 4: flagao folded before Flop (didn't bet)
Seat 7: alebitenco (button) folded before Flop (didn't bet)



PokerStars Hand #189313460718: Tournament #2369778109, $0.23+$0.02 USD Hold'em No Limit - Level XI (400/800) - 2018/07/29 22:07:17 ET
Table '2369778109 3' 9-max Seat #1 is the button
Seat 1: MegadethChug (2122 in chips) 
Seat 2: dioclecio13 (17862 in chips) 
Seat 3: Axxxidental (10376 in chips) 
Seat 4: flagao (27488 in chips) 
Seat 7: alebitenco (9652 in chips) 
MegadethChug: posts the ante 50
dioclecio13: posts the ante 50
Axxxidental: posts the ante 50
flagao: posts the ante 50
alebitenco: posts the ante 50
dioclecio13: posts small blind 400
Axxxidental: posts big blind 800
*** HOLE CARDS ***
Dealt to flagao [Kc 9h]
flagao: raises 800 to 1600
alebitenco: folds 
MegadethChug: folds 
dioclecio13: folds 
Axxxidental: folds 
Uncalled bet (800) returned to flagao
flagao collected 2250 from pot
flagao: doesn't show hand 
*** SUMMARY ***
Total pot 2250 | Rake 0 
Seat 1: MegadethChug (button) folded before Flop (didn't bet)
Seat 2: dioclecio13 (small blind) folded before Flop
Seat 3: Axxxidental (big blind) folded before Flop
Seat 4: flagao collected (2250)
Seat 7: alebitenco folded before Flop (didn't bet)



PokerStars Hand #189313465096: Tournament #2369778109, $0.23+$0.02 USD Hold'em No Limit - Level XI (400/800) - 2018/07/29 22:07:31 ET
Table '2369778109 3' 9-max Seat #2 is the button
Seat 1: MegadethChug (2072 in chips) 
Seat 2: dioclecio13 (17412 in chips) 
Seat 3: Axxxidental (9526 in chips) 
Seat 4: flagao (28888 in chips) 
Seat 7: alebitenco (9602 in chips) 
MegadethChug: posts the ante 50
dioclecio13: posts the ante 50
Axxxidental: posts the ante 50
flagao: posts the ante 50
alebitenco: posts the ante 50
Axxxidental: posts small blind 400
flagao: posts big blind 800
*** HOLE CARDS ***
Dealt to flagao [6d 9h]
alebitenco: folds 
MegadethChug: folds 
dioclecio13: folds 
Axxxidental: folds 
Uncalled bet (400) returned to flagao
flagao collected 1050 from pot
flagao: doesn't show hand 
*** SUMMARY ***
Total pot 1050 | Rake 0 
Seat 1: MegadethChug folded before Flop (didn't bet)
Seat 2: dioclecio13 (button) folded before Flop (didn't bet)
Seat 3: Axxxidental (small blind) folded before Flop
Seat 4: flagao (big blind) collected (1050)
Seat 7: alebitenco folded before Flop (didn't bet)



PokerStars Hand #189313470123: Tournament #2369778109, $0.23+$0.02 USD Hold'em No Limit - Level XI (400/800) - 2018/07/29 22:07:46 ET
Table '2369778109 3' 9-max Seat #3 is the button
Seat 1: MegadethChug (2022 in chips) 
Seat 2: dioclecio13 (17362 in chips) 
Seat 3: Axxxidental (9076 in chips) 
Seat 4: flagao (29488 in chips) 
Seat 7: alebitenco (9552 in chips) 
MegadethChug: posts the ante 50
dioclecio13: posts the ante 50
Axxxidental: posts the ante 50
flagao: posts the ante 50
alebitenco: posts the ante 50
flagao: posts small blind 400
alebitenco: posts big blind 800
*** HOLE CARDS ***
Dealt to flagao [Kh Jh]
MegadethChug: raises 1172 to 1972 and is all-in
dioclecio13: folds 
Axxxidental: calls 1972
flagao: folds 
alebitenco: folds 
*** FLOP *** [5c 7s Qh]
*** TURN *** [5c 7s Qh] [6h]
*** RIVER *** [5c 7s Qh 6h] [5d]
*** SHOW DOWN ***
MegadethChug: shows [Qs 8c] (two pair, Queens and Fives)
Axxxidental: shows [7d As] (two pair, Sevens and Fives)
MegadethChug collected 5394 from pot
*** SUMMARY ***
Total pot 5394 | Rake 0 
Board [5c 7s Qh 6h 5d]
Seat 1: MegadethChug showed [Qs 8c] and won (5394) with two pair, Queens and Fives
Seat 2: dioclecio13 folded before Flop (didn't bet)
Seat 3: Axxxidental (button) showed [7d As] and lost with two pair, Sevens and Fives
Seat 4: flagao (small blind) folded before Flop
Seat 7: alebitenco (big blind) folded before Flop



PokerStars Hand #189313478821: Tournament #2369778109, $0.23+$0.02 USD Hold'em No Limit - Level XI (400/800) - 2018/07/29 22:08:13 ET
Table '2369778109 3' 9-max Seat #4 is the button
Seat 1: MegadethChug (5394 in chips) 
Seat 2: dioclecio13 (17312 in chips) 
Seat 3: Axxxidental (7054 in chips) 
Seat 4: flagao (29038 in chips) 
Seat 7: alebitenco (8702 in chips) 
MegadethChug: posts the ante 50
dioclecio13: posts the ante 50
Axxxidental: posts the ante 50
flagao: posts the ante 50
alebitenco: posts the ante 50
alebitenco: posts small blind 400
MegadethChug: posts big blind 800
*** HOLE CARDS ***
Dealt to flagao [7c Ks]
dioclecio13: folds 
Axxxidental: raises 6204 to 7004 and is all-in
flagao: folds 
alebitenco: folds 
MegadethChug: folds 
Uncalled bet (6204) returned to Axxxidental
Axxxidental collected 2250 from pot
*** SUMMARY ***
Total pot 2250 | Rake 0 
Seat 1: MegadethChug (big blind) folded before Flop
Seat 2: dioclecio13 folded before Flop (didn't bet)
Seat 3: Axxxidental collected (2250)
Seat 4: flagao (button) folded before Flop (didn't bet)
Seat 7: alebitenco (small blind) folded before Flop



PokerStars Hand #189313484634: Tournament #2369778109, $0.23+$0.02 USD Hold'em No Limit - Level XI (400/800) - 2018/07/29 22:08:32 ET
Table '2369778109 3' 9-max Seat #7 is the button
Seat 1: MegadethChug (4544 in chips) 
Seat 2: dioclecio13 (17262 in chips) 
Seat 3: Axxxidental (8454 in chips) 
Seat 4: flagao (28988 in chips) 
Seat 7: alebitenco (8252 in chips) 
MegadethChug: posts the ante 50
dioclecio13: posts the ante 50
Axxxidental: posts the ante 50
flagao: posts the ante 50
alebitenco: posts the ante 50
MegadethChug: posts small blind 400
dioclecio13: posts big blind 800
*** HOLE CARDS ***
Dealt to flagao [9h Ad]
Axxxidental: folds 
flagao: raises 800 to 1600
alebitenco: folds 
MegadethChug: folds 
dioclecio13: calls 800
*** FLOP *** [5h Qd Ah]
dioclecio13: checks 
flagao: bets 2400
dioclecio13: folds 
Uncalled bet (2400) returned to flagao
flagao collected 3850 from pot
flagao: doesn't show hand 
*** SUMMARY ***
Total pot 3850 | Rake 0 
Board [5h Qd Ah]
Seat 1: MegadethChug (small blind) folded before Flop
Seat 2: dioclecio13 (big blind) folded on the Flop
Seat 3: Axxxidental folded before Flop (didn't bet)
Seat 4: flagao collected (3850)
Seat 7: alebitenco (button) folded before Flop (didn't bet)



PokerStars Hand #189313496486: Tournament #2369778109, $0.23+$0.02 USD Hold'em No Limit - Level XI (400/800) - 2018/07/29 22:09:09 ET
Table '2369778109 3' 9-max Seat #1 is the button
Seat 1: MegadethChug (4094 in chips) 
Seat 2: dioclecio13 (15612 in chips) 
Seat 3: Axxxidental (8404 in chips) 
Seat 4: flagao (31188 in chips) 
Seat 7: alebitenco (8202 in chips) 
MegadethChug: posts the ante 50
dioclecio13: posts the ante 50
Axxxidental: posts the ante 50
flagao: posts the ante 50
alebitenco: posts the ante 50
dioclecio13: posts small blind 400
Axxxidental: posts big blind 800
*** HOLE CARDS ***
Dealt to flagao [Jc 6h]
flagao: folds 
alebitenco: folds 
MegadethChug: folds 
dioclecio13: raises 14762 to 15562 and is all-in
Axxxidental: folds 
Uncalled bet (14762) returned to dioclecio13
dioclecio13 collected 1850 from pot
dioclecio13: doesn't show hand 
*** SUMMARY ***
Total pot 1850 | Rake 0 
Seat 1: MegadethChug (button) folded before Flop (didn't bet)
Seat 2: dioclecio13 (small blind) collected (1850)
Seat 3: Axxxidental (big blind) folded before Flop
Seat 4: flagao folded before Flop (didn't bet)
Seat 7: alebitenco folded before Flop (didn't bet)



PokerStars Hand #189313505349: Tournament #2369778109, $0.23+$0.02 USD Hold'em No Limit - Level XI (400/800) - 2018/07/29 22:09:36 ET
Table '2369778109 3' 9-max Seat #2 is the button
Seat 1: MegadethChug (4044 in chips) 
Seat 2: dioclecio13 (16612 in chips) 
Seat 3: Axxxidental (7554 in chips) 
Seat 4: flagao (31138 in chips) 
Seat 7: alebitenco (8152 in chips) 
MegadethChug: posts the ante 50
dioclecio13: posts the ante 50
Axxxidental: posts the ante 50
flagao: posts the ante 50
alebitenco: posts the ante 50
Axxxidental: posts small blind 400
flagao: posts big blind 800
*** HOLE CARDS ***
Dealt to flagao [As 6d]
alebitenco: folds 
MegadethChug: folds 
dioclecio13: folds 
Axxxidental: folds 
Uncalled bet (400) returned to flagao
flagao collected 1050 from pot
flagao: doesn't show hand 
*** SUMMARY ***
Total pot 1050 | Rake 0 
Seat 1: MegadethChug folded before Flop (didn't bet)
Seat 2: dioclecio13 (button) folded before Flop (didn't bet)
Seat 3: Axxxidental (small blind) folded before Flop
Seat 4: flagao (big blind) collected (1050)
Seat 7: alebitenco folded before Flop (didn't bet)



PokerStars Hand #189313510789: Tournament #2369778109, $0.23+$0.02 USD Hold'em No Limit - Level XI (400/800) - 2018/07/29 22:09:54 ET
Table '2369778109 3' 9-max Seat #3 is the button
Seat 1: MegadethChug (3994 in chips) 
Seat 2: dioclecio13 (16562 in chips) 
Seat 3: Axxxidental (7104 in chips) 
Seat 4: flagao (31738 in chips) 
Seat 7: alebitenco (8102 in chips) 
MegadethChug: posts the ante 50
dioclecio13: posts the ante 50
Axxxidental: posts the ante 50
flagao: posts the ante 50
alebitenco: posts the ante 50
flagao: posts small blind 400
alebitenco: posts big blind 800
*** HOLE CARDS ***
Dealt to flagao [7d 8d]
MegadethChug: folds 
dioclecio13: folds 
Axxxidental: folds 
flagao: raises 800 to 1600
alebitenco: calls 800
*** FLOP *** [6s 4c 7h]
flagao: bets 2400
alebitenco: folds 
Uncalled bet (2400) returned to flagao
flagao collected 3450 from pot
flagao: doesn't show hand 
*** SUMMARY ***
Total pot 3450 | Rake 0 
Board [6s 4c 7h]
Seat 1: MegadethChug folded before Flop (didn't bet)
Seat 2: dioclecio13 folded before Flop (didn't bet)
Seat 3: Axxxidental (button) folded before Flop (didn't bet)
Seat 4: flagao (small blind) collected (3450)
Seat 7: alebitenco (big blind) folded on the Flop



PokerStars Hand #189313520745: Tournament #2369778109, $0.23+$0.02 USD Hold'em No Limit - Level XI (400/800) - 2018/07/29 22:10:26 ET
Table '2369778109 3' 9-max Seat #4 is the button
Seat 1: MegadethChug (3944 in chips) 
Seat 2: dioclecio13 (16512 in chips) 
Seat 3: Axxxidental (7054 in chips) 
Seat 4: flagao (33538 in chips) 
Seat 7: alebitenco (6452 in chips) 
MegadethChug: posts the ante 50
dioclecio13: posts the ante 50
Axxxidental: posts the ante 50
flagao: posts the ante 50
alebitenco: posts the ante 50
alebitenco: posts small blind 400
MegadethChug: posts big blind 800
*** HOLE CARDS ***
Dealt to flagao [Tc 6s]
dioclecio13: folds 
Axxxidental: folds 
flagao: folds 
alebitenco: raises 5602 to 6402 and is all-in
MegadethChug: folds 
Uncalled bet (5602) returned to alebitenco
alebitenco collected 1850 from pot
alebitenco: doesn't show hand 
*** SUMMARY ***
Total pot 1850 | Rake 0 
Seat 1: MegadethChug (big blind) folded before Flop
Seat 2: dioclecio13 folded before Flop (didn't bet)
Seat 3: Axxxidental folded before Flop (didn't bet)
Seat 4: flagao (button) folded before Flop (didn't bet)
Seat 7: alebitenco (small blind) collected (1850)



PokerStars Hand #189313525201: Tournament #2369778109, $0.23+$0.02 USD Hold'em No Limit - Level XI (400/800) - 2018/07/29 22:10:40 ET
Table '2369778109 3' 9-max Seat #7 is the button
Seat 1: MegadethChug (3094 in chips) 
Seat 2: dioclecio13 (16462 in chips) 
Seat 3: Axxxidental (7004 in chips) 
Seat 4: flagao (33488 in chips) 
Seat 7: alebitenco (7452 in chips) 
MegadethChug: posts the ante 50
dioclecio13: posts the ante 50
Axxxidental: posts the ante 50
flagao: posts the ante 50
alebitenco: posts the ante 50
MegadethChug: posts small blind 400
dioclecio13: posts big blind 800
*** HOLE CARDS ***
Dealt to flagao [2h 9h]
Axxxidental: raises 6154 to 6954 and is all-in
flagao: folds 
alebitenco: folds 
MegadethChug: calls 2644 and is all-in
dioclecio13: folds 
Uncalled bet (3910) returned to Axxxidental
*** FLOP *** [Ks 3h Tc]
*** TURN *** [Ks 3h Tc] [8d]
*** RIVER *** [Ks 3h Tc 8d] [4c]
*** SHOW DOWN ***
MegadethChug: shows [6d 6h] (a pair of Sixes)
Axxxidental: shows [Ac Jd] (high card Ace)
MegadethChug collected 7138 from pot
*** SUMMARY ***
Total pot 7138 | Rake 0 
Board [Ks 3h Tc 8d 4c]
Seat 1: MegadethChug (small blind) showed [6d 6h] and won (7138) with a pair of Sixes
Seat 2: dioclecio13 (big blind) folded before Flop
Seat 3: Axxxidental showed [Ac Jd] and lost with high card Ace
Seat 4: flagao folded before Flop (didn't bet)
Seat 7: alebitenco (button) folded before Flop (didn't bet)



PokerStars Hand #189313532070: Tournament #2369778109, $0.23+$0.02 USD Hold'em No Limit - Level XI (400/800) - 2018/07/29 22:11:02 ET
Table '2369778109 3' 9-max Seat #1 is the button
Seat 1: MegadethChug (7138 in chips) 
Seat 2: dioclecio13 (15612 in chips) 
Seat 3: Axxxidental (3910 in chips) 
Seat 4: flagao (33438 in chips) 
Seat 7: alebitenco (7402 in chips) 
MegadethChug: posts the ante 50
dioclecio13: posts the ante 50
Axxxidental: posts the ante 50
flagao: posts the ante 50
alebitenco: posts the ante 50
dioclecio13: posts small blind 400
Axxxidental: posts big blind 800
*** HOLE CARDS ***
Dealt to flagao [Ac 8c]
flagao: raises 800 to 1600
alebitenco: folds 
MegadethChug: folds 
dioclecio13: folds 
Axxxidental: folds 
Uncalled bet (800) returned to flagao
flagao collected 2250 from pot
flagao: doesn't show hand 
*** SUMMARY ***
Total pot 2250 | Rake 0 
Seat 1: MegadethChug (button) folded before Flop (didn't bet)
Seat 2: dioclecio13 (small blind) folded before Flop
Seat 3: Axxxidental (big blind) folded before Flop
Seat 4: flagao collected (2250)
Seat 7: alebitenco folded before Flop (didn't bet)



PokerStars Hand #189313536629: Tournament #2369778109, $0.23+$0.02 USD Hold'em No Limit - Level XI (400/800) - 2018/07/29 22:11:17 ET
Table '2369778109 3' 9-max Seat #2 is the button
Seat 1: MegadethChug (7088 in chips) 
Seat 2: dioclecio13 (15162 in chips) 
Seat 3: Axxxidental (3060 in chips) 
Seat 4: flagao (34838 in chips) 
Seat 7: alebitenco (7352 in chips) 
MegadethChug: posts the ante 50
dioclecio13: posts the ante 50
Axxxidental: posts the ante 50
flagao: posts the ante 50
alebitenco: posts the ante 50
Axxxidental: posts small blind 400
flagao: posts big blind 800
*** HOLE CARDS ***
Dealt to flagao [2h 4c]
alebitenco: folds 
MegadethChug: folds 
dioclecio13: folds 
Axxxidental: folds 
Uncalled bet (400) returned to flagao
flagao collected 1050 from pot
flagao: doesn't show hand 
*** SUMMARY ***
Total pot 1050 | Rake 0 
Seat 1: MegadethChug folded before Flop (didn't bet)
Seat 2: dioclecio13 (button) folded before Flop (didn't bet)
Seat 3: Axxxidental (small blind) folded before Flop
Seat 4: flagao (big blind) collected (1050)
Seat 7: alebitenco folded before Flop (didn't bet)



PokerStars Hand #189313543026: Tournament #2369778109, $0.23+$0.02 USD Hold'em No Limit - Level XI (400/800) - 2018/07/29 22:11:37 ET
Table '2369778109 3' 9-max Seat #3 is the button
Seat 1: MegadethChug (7038 in chips) 
Seat 2: dioclecio13 (15112 in chips) 
Seat 3: Axxxidental (2610 in chips) 
Seat 4: flagao (35438 in chips) 
Seat 7: alebitenco (7302 in chips) 
MegadethChug: posts the ante 50
dioclecio13: posts the ante 50
Axxxidental: posts the ante 50
flagao: posts the ante 50
alebitenco: posts the ante 50
flagao: posts small blind 400
alebitenco: posts big blind 800
*** HOLE CARDS ***
Dealt to flagao [Kd 8s]
MegadethChug: folds 
dioclecio13: folds 
Axxxidental: raises 1760 to 2560 and is all-in
flagao: folds 
alebitenco: folds 
Uncalled bet (1760) returned to Axxxidental
Axxxidental collected 2250 from pot
*** SUMMARY ***
Total pot 2250 | Rake 0 
Seat 1: MegadethChug folded before Flop (didn't bet)
Seat 2: dioclecio13 folded before Flop (didn't bet)
Seat 3: Axxxidental (button) collected (2250)
Seat 4: flagao (small blind) folded before Flop
Seat 7: alebitenco (big blind) folded before Flop



PokerStars Hand #189313548172: Tournament #2369778109, $0.23+$0.02 USD Hold'em No Limit - Level XI (400/800) - 2018/07/29 22:11:53 ET
Table '2369778109 3' 9-max Seat #4 is the button
Seat 1: MegadethChug (6988 in chips) 
Seat 2: dioclecio13 (15062 in chips) 
Seat 3: Axxxidental (4010 in chips) 
Seat 4: flagao (34988 in chips) 
Seat 7: alebitenco (6452 in chips) 
MegadethChug: posts the ante 50
dioclecio13: posts the ante 50
Axxxidental: posts the ante 50
flagao: posts the ante 50
alebitenco: posts the ante 50
alebitenco: posts small blind 400
MegadethChug: posts big blind 800
*** HOLE CARDS ***
Dealt to flagao [Ac 8h]
dioclecio13: folds 
Axxxidental: folds 
flagao: raises 800 to 1600
alebitenco: folds 
MegadethChug: calls 800
*** FLOP *** [Kc 6h 5h]
MegadethChug: checks 
flagao: bets 2400
MegadethChug: folds 
Uncalled bet (2400) returned to flagao
flagao collected 3850 from pot
flagao: doesn't show hand 
*** SUMMARY ***
Total pot 3850 | Rake 0 
Board [Kc 6h 5h]
Seat 1: MegadethChug (big blind) folded on the Flop
Seat 2: dioclecio13 folded before Flop (didn't bet)
Seat 3: Axxxidental folded before Flop (didn't bet)
Seat 4: flagao (button) collected (3850)
Seat 7: alebitenco (small blind) folded before Flop



PokerStars Hand #189313555817: Tournament #2369778109, $0.23+$0.02 USD Hold'em No Limit - Level XI (400/800) - 2018/07/29 22:12:18 ET
Table '2369778109 3' 9-max Seat #7 is the button
Seat 1: MegadethChug (5338 in chips) 
Seat 2: dioclecio13 (15012 in chips) 
Seat 3: Axxxidental (3960 in chips) 
Seat 4: flagao (37188 in chips) 
Seat 7: alebitenco (6002 in chips) 
MegadethChug: posts the ante 50
dioclecio13: posts the ante 50
Axxxidental: posts the ante 50
flagao: posts the ante 50
alebitenco: posts the ante 50
MegadethChug: posts small blind 400
dioclecio13: posts big blind 800
*** HOLE CARDS ***
Dealt to flagao [6s Qc]
Axxxidental: raises 3110 to 3910 and is all-in
flagao: folds 
alebitenco: folds 
MegadethChug: folds 
dioclecio13: folds 
Uncalled bet (3110) returned to Axxxidental
Axxxidental collected 2250 from pot
*** SUMMARY ***
Total pot 2250 | Rake 0 
Seat 1: MegadethChug (small blind) folded before Flop
Seat 2: dioclecio13 (big blind) folded before Flop
Seat 3: Axxxidental collected (2250)
Seat 4: flagao folded before Flop (didn't bet)
Seat 7: alebitenco (button) folded before Flop (didn't bet)



PokerStars Hand #189313560783: Tournament #2369778109, $0.23+$0.02 USD Hold'em No Limit - Level XII (500/1000) - 2018/07/29 22:12:34 ET
Table '2369778109 3' 9-max Seat #1 is the button
Seat 1: MegadethChug (4888 in chips) 
Seat 2: dioclecio13 (14162 in chips) 
Seat 3: Axxxidental (5360 in chips) 
Seat 4: flagao (37138 in chips) 
Seat 7: alebitenco (5952 in chips) 
MegadethChug: posts the ante 60
dioclecio13: posts the ante 60
Axxxidental: posts the ante 60
flagao: posts the ante 60
alebitenco: posts the ante 60
dioclecio13: posts small blind 500
Axxxidental: posts big blind 1000
*** HOLE CARDS ***
Dealt to flagao [3d Kd]
flagao: folds 
alebitenco: folds 
MegadethChug: folds 
dioclecio13: raises 13102 to 14102 and is all-in
Axxxidental: folds 
Uncalled bet (13102) returned to dioclecio13
dioclecio13 collected 2300 from pot
dioclecio13: doesn't show hand 
*** SUMMARY ***
Total pot 2300 | Rake 0 
Seat 1: MegadethChug (button) folded before Flop (didn't bet)
Seat 2: dioclecio13 (small blind) collected (2300)
Seat 3: Axxxidental (big blind) folded before Flop
Seat 4: flagao folded before Flop (didn't bet)
Seat 7: alebitenco folded before Flop (didn't bet)



PokerStars Hand #189313567014: Tournament #2369778109, $0.23+$0.02 USD Hold'em No Limit - Level XII (500/1000) - 2018/07/29 22:12:54 ET
Table '2369778109 3' 9-max Seat #2 is the button
Seat 1: MegadethChug (4828 in chips) 
Seat 2: dioclecio13 (15402 in chips) 
Seat 3: Axxxidental (4300 in chips) 
Seat 4: flagao (37078 in chips) 
Seat 7: alebitenco (5892 in chips) 
MegadethChug: posts the ante 60
dioclecio13: posts the ante 60
Axxxidental: posts the ante 60
flagao: posts the ante 60
alebitenco: posts the ante 60
Axxxidental: posts small blind 500
flagao: posts big blind 1000
*** HOLE CARDS ***
Dealt to flagao [7d Jh]
alebitenco: folds 
MegadethChug: folds 
dioclecio13: folds 
Axxxidental: folds 
Uncalled bet (500) returned to flagao
flagao collected 1300 from pot
flagao: doesn't show hand 
*** SUMMARY ***
Total pot 1300 | Rake 0 
Seat 1: MegadethChug folded before Flop (didn't bet)
Seat 2: dioclecio13 (button) folded before Flop (didn't bet)
Seat 3: Axxxidental (small blind) folded before Flop
Seat 4: flagao (big blind) collected (1300)
Seat 7: alebitenco folded before Flop (didn't bet)



PokerStars Hand #189313571945: Tournament #2369778109, $0.23+$0.02 USD Hold'em No Limit - Level XII (500/1000) - 2018/07/29 22:13:09 ET
Table '2369778109 3' 9-max Seat #3 is the button
Seat 1: MegadethChug (4768 in chips) 
Seat 2: dioclecio13 (15342 in chips) 
Seat 3: Axxxidental (3740 in chips) 
Seat 4: flagao (37818 in chips) 
Seat 7: alebitenco (5832 in chips) 
MegadethChug: posts the ante 60
dioclecio13: posts the ante 60
Axxxidental: posts the ante 60
flagao: posts the ante 60
alebitenco: posts the ante 60
flagao: posts small blind 500
alebitenco: posts big blind 1000
*** HOLE CARDS ***
Dealt to flagao [7c 2h]
MegadethChug: folds 
dioclecio13: raises 14282 to 15282 and is all-in
Axxxidental: folds 
flagao: folds 
alebitenco: folds 
Uncalled bet (14282) returned to dioclecio13
dioclecio13 collected 2800 from pot
dioclecio13: doesn't show hand 
*** SUMMARY ***
Total pot 2800 | Rake 0 
Seat 1: MegadethChug folded before Flop (didn't bet)
Seat 2: dioclecio13 collected (2800)
Seat 3: Axxxidental (button) folded before Flop (didn't bet)
Seat 4: flagao (small blind) folded before Flop
Seat 7: alebitenco (big blind) folded before Flop



PokerStars Hand #189313576507: Tournament #2369778109, $0.23+$0.02 USD Hold'em No Limit - Level XII (500/1000) - 2018/07/29 22:13:24 ET
Table '2369778109 3' 9-max Seat #4 is the button
Seat 1: MegadethChug (4708 in chips) 
Seat 2: dioclecio13 (17082 in chips) 
Seat 3: Axxxidental (3680 in chips) 
Seat 4: flagao (37258 in chips) 
Seat 7: alebitenco (4772 in chips) 
MegadethChug: posts the ante 60
dioclecio13: posts the ante 60
Axxxidental: posts the ante 60
flagao: posts the ante 60
alebitenco: posts the ante 60
alebitenco: posts small blind 500
MegadethChug: posts big blind 1000
*** HOLE CARDS ***
Dealt to flagao [3s 6h]
dioclecio13: folds 
Axxxidental: folds 
flagao: folds 
alebitenco: folds 
Uncalled bet (500) returned to MegadethChug
MegadethChug collected 1300 from pot
*** SUMMARY ***
Total pot 1300 | Rake 0 
Seat 1: MegadethChug (big blind) collected (1300)
Seat 2: dioclecio13 folded before Flop (didn't bet)
Seat 3: Axxxidental folded before Flop (didn't bet)
Seat 4: flagao (button) folded before Flop (didn't bet)
Seat 7: alebitenco (small blind) folded before Flop



PokerStars Hand #189313580894: Tournament #2369778109, $0.23+$0.02 USD Hold'em No Limit - Level XII (500/1000) - 2018/07/29 22:13:38 ET
Table '2369778109 3' 9-max Seat #7 is the button
Seat 1: MegadethChug (5448 in chips) 
Seat 2: dioclecio13 (17022 in chips) 
Seat 3: Axxxidental (3620 in chips) 
Seat 4: flagao (37198 in chips) 
Seat 7: alebitenco (4212 in chips) 
MegadethChug: posts the ante 60
dioclecio13: posts the ante 60
Axxxidental: posts the ante 60
flagao: posts the ante 60
alebitenco: posts the ante 60
MegadethChug: posts small blind 500
dioclecio13: posts big blind 1000
*** HOLE CARDS ***
Dealt to flagao [3c Qh]
Axxxidental: raises 2560 to 3560 and is all-in
flagao: folds 
alebitenco: folds 
MegadethChug: folds 
dioclecio13: calls 2560
*** FLOP *** [9d 9h 3s]
*** TURN *** [9d 9h 3s] [2c]
*** RIVER *** [9d 9h 3s 2c] [Jc]
*** SHOW DOWN ***
dioclecio13: shows [6d As] (a pair of Nines)
Axxxidental: shows [Ts Qd] (a pair of Nines - lower kicker)
dioclecio13 collected 7920 from pot
Axxxidental finished the tournament in 5th place and received $0.93.
*** SUMMARY ***
Total pot 7920 | Rake 0 
Board [9d 9h 3s 2c Jc]
Seat 1: MegadethChug (small blind) folded before Flop
Seat 2: dioclecio13 (big blind) showed [6d As] and won (7920) with a pair of Nines
Seat 3: Axxxidental showed [Ts Qd] and lost with a pair of Nines
Seat 4: flagao folded before Flop (didn't bet)
Seat 7: alebitenco (button) folded before Flop (didn't bet)



PokerStars Hand #189313587184: Tournament #2369778109, $0.23+$0.02 USD Hold'em No Limit - Level XII (500/1000) - 2018/07/29 22:13:58 ET
Table '2369778109 3' 9-max Seat #1 is the button
Seat 1: MegadethChug (4888 in chips) 
Seat 2: dioclecio13 (21322 in chips) 
Seat 4: flagao (37138 in chips) 
Seat 7: alebitenco (4152 in chips) 
MegadethChug: posts the ante 60
dioclecio13: posts the ante 60
flagao: posts the ante 60
alebitenco: posts the ante 60
dioclecio13: posts small blind 500
flagao: posts big blind 1000
*** HOLE CARDS ***
Dealt to flagao [5h Th]
alebitenco: raises 3092 to 4092 and is all-in
MegadethChug: folds 
dioclecio13: folds 
flagao: folds 
Uncalled bet (3092) returned to alebitenco
alebitenco collected 2740 from pot
alebitenco: doesn't show hand 
*** SUMMARY ***
Total pot 2740 | Rake 0 
Seat 1: MegadethChug (button) folded before Flop (didn't bet)
Seat 2: dioclecio13 (small blind) folded before Flop
Seat 4: flagao (big blind) folded before Flop
Seat 7: alebitenco collected (2740)



PokerStars Hand #189313591565: Tournament #2369778109, $0.23+$0.02 USD Hold'em No Limit - Level XII (500/1000) - 2018/07/29 22:14:12 ET
Table '2369778109 3' 9-max Seat #2 is the button
Seat 1: MegadethChug (4828 in chips) 
Seat 2: dioclecio13 (20762 in chips) 
Seat 4: flagao (36078 in chips) 
Seat 7: alebitenco (5832 in chips) 
MegadethChug: posts the ante 60
dioclecio13: posts the ante 60
flagao: posts the ante 60
alebitenco: posts the ante 60
flagao: posts small blind 500
alebitenco: posts big blind 1000
*** HOLE CARDS ***
Dealt to flagao [9c 9h]
MegadethChug: folds 
dioclecio13: raises 1000 to 2000
flagao: calls 1500
alebitenco: folds 
*** FLOP *** [2s Th Qc]
flagao: bets 3000
dioclecio13: calls 3000
*** TURN *** [2s Th Qc] [6s]
flagao: checks 
dioclecio13: bets 4946
flagao: folds 
Uncalled bet (4946) returned to dioclecio13
dioclecio13 collected 11240 from pot
dioclecio13: doesn't show hand 
*** SUMMARY ***
Total pot 11240 | Rake 0 
Board [2s Th Qc 6s]
Seat 1: MegadethChug folded before Flop (didn't bet)
Seat 2: dioclecio13 (button) collected (11240)
Seat 4: flagao (small blind) folded on the Turn
Seat 7: alebitenco (big blind) folded before Flop



PokerStars Hand #189313603940: Tournament #2369778109, $0.23+$0.02 USD Hold'em No Limit - Level XII (500/1000) - 2018/07/29 22:14:52 ET
Table '2369778109 3' 9-max Seat #4 is the button
Seat 1: MegadethChug (4768 in chips) 
Seat 2: dioclecio13 (26942 in chips) 
Seat 4: flagao (31018 in chips) 
Seat 7: alebitenco (4772 in chips) 
MegadethChug: posts the ante 60
dioclecio13: posts the ante 60
flagao: posts the ante 60
alebitenco: posts the ante 60
alebitenco: posts small blind 500
MegadethChug: posts big blind 1000
*** HOLE CARDS ***
Dealt to flagao [4h 3h]
dioclecio13: folds 
flagao: folds 
alebitenco: raises 3712 to 4712 and is all-in
MegadethChug: folds 
Uncalled bet (3712) returned to alebitenco
alebitenco collected 2240 from pot
alebitenco: doesn't show hand 
*** SUMMARY ***
Total pot 2240 | Rake 0 
Seat 1: MegadethChug (big blind) folded before Flop
Seat 2: dioclecio13 folded before Flop (didn't bet)
Seat 4: flagao (button) folded before Flop (didn't bet)
Seat 7: alebitenco (small blind) collected (2240)



PokerStars Hand #189313609721: Tournament #2369778109, $0.23+$0.02 USD Hold'em No Limit - Level XII (500/1000) - 2018/07/29 22:15:11 ET
Table '2369778109 3' 9-max Seat #7 is the button
Seat 1: MegadethChug (3708 in chips) 
Seat 2: dioclecio13 (26882 in chips) 
Seat 4: flagao (30958 in chips) 
Seat 7: alebitenco (5952 in chips) 
MegadethChug: posts the ante 60
dioclecio13: posts the ante 60
flagao: posts the ante 60
alebitenco: posts the ante 60
MegadethChug: posts small blind 500
dioclecio13: posts big blind 1000
*** HOLE CARDS ***
Dealt to flagao [Qc Ad]
flagao: raises 1500 to 2500
alebitenco: folds 
MegadethChug: folds 
dioclecio13: calls 1500
*** FLOP *** [9s Jh 2d]
dioclecio13: checks 
flagao: bets 4000
dioclecio13: folds 
Uncalled bet (4000) returned to flagao
flagao collected 5740 from pot
flagao: doesn't show hand 
*** SUMMARY ***
Total pot 5740 | Rake 0 
Board [9s Jh 2d]
Seat 1: MegadethChug (small blind) folded before Flop
Seat 2: dioclecio13 (big blind) folded on the Flop
Seat 4: flagao collected (5740)
Seat 7: alebitenco (button) folded before Flop (didn't bet)



PokerStars Hand #189313619097: Tournament #2369778109, $0.23+$0.02 USD Hold'em No Limit - Level XII (500/1000) - 2018/07/29 22:15:41 ET
Table '2369778109 3' 9-max Seat #1 is the button
Seat 1: MegadethChug (3148 in chips) 
Seat 2: dioclecio13 (24322 in chips) 
Seat 4: flagao (34138 in chips) 
Seat 7: alebitenco (5892 in chips) 
MegadethChug: posts the ante 60
dioclecio13: posts the ante 60
flagao: posts the ante 60
alebitenco: posts the ante 60
dioclecio13: posts small blind 500
flagao: posts big blind 1000
*** HOLE CARDS ***
Dealt to flagao [2s Qd]
alebitenco: folds 
MegadethChug: raises 2088 to 3088 and is all-in
dioclecio13: folds 
flagao: folds 
Uncalled bet (2088) returned to MegadethChug
MegadethChug collected 2740 from pot
*** SUMMARY ***
Total pot 2740 | Rake 0 
Seat 1: MegadethChug (button) collected (2740)
Seat 2: dioclecio13 (small blind) folded before Flop
Seat 4: flagao (big blind) folded before Flop
Seat 7: alebitenco folded before Flop (didn't bet)



PokerStars Hand #189313624961: Tournament #2369778109, $0.23+$0.02 USD Hold'em No Limit - Level XII (500/1000) - 2018/07/29 22:16:00 ET
Table '2369778109 3' 9-max Seat #2 is the button
Seat 1: MegadethChug (4828 in chips) 
Seat 2: dioclecio13 (23762 in chips) 
Seat 4: flagao (33078 in chips) 
Seat 7: alebitenco (5832 in chips) 
MegadethChug: posts the ante 60
dioclecio13: posts the ante 60
flagao: posts the ante 60
alebitenco: posts the ante 60
flagao: posts small blind 500
alebitenco: posts big blind 1000
*** HOLE CARDS ***
Dealt to flagao [Qd As]
MegadethChug: folds 
dioclecio13: raises 1000 to 2000
flagao: calls 1500
alebitenco: folds 
*** FLOP *** [Tc 7s Ad]
flagao: checks 
dioclecio13: bets 2306
flagao: calls 2306
*** TURN *** [Tc 7s Ad] [Qc]
flagao: checks 
dioclecio13: checks 
*** RIVER *** [Tc 7s Ad Qc] [4d]
flagao: bets 5000
dioclecio13: folds 
Uncalled bet (5000) returned to flagao
flagao collected 9852 from pot
flagao: doesn't show hand 
*** SUMMARY ***
Total pot 9852 | Rake 0 
Board [Tc 7s Ad Qc 4d]
Seat 1: MegadethChug folded before Flop (didn't bet)
Seat 2: dioclecio13 (button) folded on the River
Seat 4: flagao (small blind) collected (9852)
Seat 7: alebitenco (big blind) folded before Flop



PokerStars Hand #189313638514: Tournament #2369778109, $0.23+$0.02 USD Hold'em No Limit - Level XII (500/1000) - 2018/07/29 22:16:44 ET
Table '2369778109 3' 9-max Seat #4 is the button
Seat 1: MegadethChug (4768 in chips) 
Seat 2: dioclecio13 (19396 in chips) 
Seat 4: flagao (38564 in chips) 
Seat 7: alebitenco (4772 in chips) 
MegadethChug: posts the ante 60
dioclecio13: posts the ante 60
flagao: posts the ante 60
alebitenco: posts the ante 60
alebitenco: posts small blind 500
MegadethChug: posts big blind 1000
*** HOLE CARDS ***
Dealt to flagao [8d Td]
dioclecio13: folds 
flagao: raises 1000 to 2000
alebitenco: folds 
MegadethChug: folds 
Uncalled bet (1000) returned to flagao
flagao collected 2740 from pot
flagao: doesn't show hand 
*** SUMMARY ***
Total pot 2740 | Rake 0 
Seat 1: MegadethChug (big blind) folded before Flop
Seat 2: dioclecio13 folded before Flop (didn't bet)
Seat 4: flagao (button) collected (2740)
Seat 7: alebitenco (small blind) folded before Flop



PokerStars Hand #189313643651: Tournament #2369778109, $0.23+$0.02 USD Hold'em No Limit - Level XII (500/1000) - 2018/07/29 22:17:00 ET
Table '2369778109 3' 9-max Seat #7 is the button
Seat 1: MegadethChug (3708 in chips) 
Seat 2: dioclecio13 (19336 in chips) 
Seat 4: flagao (40244 in chips) 
Seat 7: alebitenco (4212 in chips) 
MegadethChug: posts the ante 60
dioclecio13: posts the ante 60
flagao: posts the ante 60
alebitenco: posts the ante 60
MegadethChug: posts small blind 500
dioclecio13: posts big blind 1000
*** HOLE CARDS ***
Dealt to flagao [5d 7d]
flagao: folds 
alebitenco: raises 3152 to 4152 and is all-in
MegadethChug: calls 3148 and is all-in
dioclecio13: folds 
Uncalled bet (504) returned to alebitenco
*** FLOP *** [9s 7s 2c]
*** TURN *** [9s 7s 2c] [4s]
*** RIVER *** [9s 7s 2c 4s] [5c]
*** SHOW DOWN ***
MegadethChug: shows [As Tc] (high card Ace)
alebitenco: shows [Jd Kh] (high card King)
MegadethChug collected 8536 from pot
*** SUMMARY ***
Total pot 8536 | Rake 0 
Board [9s 7s 2c 4s 5c]
Seat 1: MegadethChug (small blind) showed [As Tc] and won (8536) with high card Ace
Seat 2: dioclecio13 (big blind) folded before Flop
Seat 4: flagao folded before Flop (didn't bet)
Seat 7: alebitenco (button) showed [Jd Kh] and lost with high card King



PokerStars Hand #189313650059: Tournament #2369778109, $0.23+$0.02 USD Hold'em No Limit - Level XII (500/1000) - 2018/07/29 22:17:21 ET
Table '2369778109 3' 9-max Seat #1 is the button
Seat 1: MegadethChug (8536 in chips) 
Seat 2: dioclecio13 (18276 in chips) 
Seat 4: flagao (40184 in chips) 
Seat 7: alebitenco (504 in chips) 
MegadethChug: posts the ante 60
dioclecio13: posts the ante 60
flagao: posts the ante 60
alebitenco: posts the ante 60
dioclecio13: posts small blind 500
flagao: posts big blind 1000
*** HOLE CARDS ***
Dealt to flagao [6h Jc]
alebitenco: calls 444 and is all-in
MegadethChug: calls 1000
dioclecio13: raises 17216 to 18216 and is all-in
flagao: folds 
MegadethChug: folds 
Uncalled bet (17216) returned to dioclecio13
*** FLOP *** [7d 3c 7h]
*** TURN *** [7d 3c 7h] [Qc]
*** RIVER *** [7d 3c 7h Qc] [Ah]
*** SHOW DOWN ***
dioclecio13: shows [9c 9d] (two pair, Nines and Sevens)
dioclecio13 collected 1668 from side pot
alebitenco: shows [8s 3s] (two pair, Sevens and Threes)
dioclecio13 collected 2016 from main pot
alebitenco finished the tournament in 4th place and received $1.29.
*** SUMMARY ***
Total pot 3684 Main pot 2016. Side pot 1668. | Rake 0 
Board [7d 3c 7h Qc Ah]
Seat 1: MegadethChug (button) folded before Flop
Seat 2: dioclecio13 (small blind) showed [9c 9d] and won (3684) with two pair, Nines and Sevens
Seat 4: flagao (big blind) folded before Flop
Seat 7: alebitenco showed [8s 3s] and lost with two pair, Sevens and Threes



PokerStars Hand #189313658268: Tournament #2369778109, $0.23+$0.02 USD Hold'em No Limit - Level XII (500/1000) - 2018/07/29 22:17:48 ET
Table '2369778109 3' 9-max Seat #2 is the button
Seat 1: MegadethChug (7476 in chips) 
Seat 2: dioclecio13 (20900 in chips) 
Seat 4: flagao (39124 in chips) 
MegadethChug: posts the ante 60
dioclecio13: posts the ante 60
flagao: posts the ante 60
flagao: posts small blind 500
MegadethChug: posts big blind 1000
*** HOLE CARDS ***
Dealt to flagao [Ad Jc]
dioclecio13: folds 
flagao: raises 1500 to 2500
MegadethChug: folds 
Uncalled bet (1500) returned to flagao
flagao collected 2180 from pot
flagao: doesn't show hand 
*** SUMMARY ***
Total pot 2180 | Rake 0 
Seat 1: MegadethChug (big blind) folded before Flop
Seat 2: dioclecio13 (button) folded before Flop (didn't bet)
Seat 4: flagao (small blind) collected (2180)



PokerStars Hand #189313663572: Tournament #2369778109, $0.23+$0.02 USD Hold'em No Limit - Level XII (500/1000) - 2018/07/29 22:18:05 ET
Table '2369778109 3' 9-max Seat #4 is the button
Seat 1: MegadethChug (6416 in chips) 
Seat 2: dioclecio13 (20840 in chips) 
Seat 4: flagao (40244 in chips) 
MegadethChug: posts the ante 60
dioclecio13: posts the ante 60
flagao: posts the ante 60
MegadethChug: posts small blind 500
dioclecio13: posts big blind 1000
*** HOLE CARDS ***
Dealt to flagao [Qd 3c]
flagao: folds 
MegadethChug: folds 
Uncalled bet (500) returned to dioclecio13
dioclecio13 collected 1180 from pot
dioclecio13: doesn't show hand 
*** SUMMARY ***
Total pot 1180 | Rake 0 
Seat 1: MegadethChug (small blind) folded before Flop
Seat 2: dioclecio13 (big blind) collected (1180)
Seat 4: flagao (button) folded before Flop (didn't bet)



PokerStars Hand #189313666404: Tournament #2369778109, $0.23+$0.02 USD Hold'em No Limit - Level XII (500/1000) - 2018/07/29 22:18:15 ET
Table '2369778109 3' 9-max Seat #1 is the button
Seat 1: MegadethChug (5856 in chips) 
Seat 2: dioclecio13 (21460 in chips) 
Seat 4: flagao (40184 in chips) 
MegadethChug: posts the ante 60
dioclecio13: posts the ante 60
flagao: posts the ante 60
dioclecio13: posts small blind 500
flagao: posts big blind 1000
*** HOLE CARDS ***
Dealt to flagao [2s Kc]
MegadethChug: raises 4796 to 5796 and is all-in
dioclecio13: raises 15604 to 21400 and is all-in
flagao: folds 
Uncalled bet (15604) returned to dioclecio13
*** FLOP *** [2c 9c Jd]
*** TURN *** [2c 9c Jd] [8d]
*** RIVER *** [2c 9c Jd 8d] [2h]
*** SHOW DOWN ***
dioclecio13: shows [Ad 8s] (two pair, Eights and Deuces)
MegadethChug: shows [As 9d] (two pair, Nines and Deuces)
MegadethChug collected 12772 from pot
*** SUMMARY ***
Total pot 12772 | Rake 0 
Board [2c 9c Jd 8d 2h]
Seat 1: MegadethChug (button) showed [As 9d] and won (12772) with two pair, Nines and Deuces
Seat 2: dioclecio13 (small blind) showed [Ad 8s] and lost with two pair, Eights and Deuces
Seat 4: flagao (big blind) folded before Flop



PokerStars Hand #189313672405: Tournament #2369778109, $0.23+$0.02 USD Hold'em No Limit - Level XII (500/1000) - 2018/07/29 22:18:34 ET
Table '2369778109 3' 9-max Seat #2 is the button
Seat 1: MegadethChug (12772 in chips) 
Seat 2: dioclecio13 (15604 in chips) 
Seat 4: flagao (39124 in chips) 
MegadethChug: posts the ante 60
dioclecio13: posts the ante 60
flagao: posts the ante 60
flagao: posts small blind 500
MegadethChug: posts big blind 1000
*** HOLE CARDS ***
Dealt to flagao [Ks Jc]
dioclecio13: raises 14544 to 15544 and is all-in
flagao: folds 
MegadethChug: folds 
Uncalled bet (14544) returned to dioclecio13
dioclecio13 collected 2680 from pot
dioclecio13: doesn't show hand 
*** SUMMARY ***
Total pot 2680 | Rake 0 
Seat 1: MegadethChug (big blind) folded before Flop
Seat 2: dioclecio13 (button) collected (2680)
Seat 4: flagao (small blind) folded before Flop



PokerStars Hand #189313677766: Tournament #2369778109, $0.23+$0.02 USD Hold'em No Limit - Level XII (500/1000) - 2018/07/29 22:18:52 ET
Table '2369778109 3' 9-max Seat #4 is the button
Seat 1: MegadethChug (11712 in chips) 
Seat 2: dioclecio13 (17224 in chips) 
Seat 4: flagao (38564 in chips) 
MegadethChug: posts the ante 60
dioclecio13: posts the ante 60
flagao: posts the ante 60
MegadethChug: posts small blind 500
dioclecio13: posts big blind 1000
*** HOLE CARDS ***
Dealt to flagao [2h Jd]
flagao: folds 
MegadethChug: folds 
Uncalled bet (500) returned to dioclecio13
dioclecio13 collected 1180 from pot
dioclecio13: doesn't show hand 
*** SUMMARY ***
Total pot 1180 | Rake 0 
Seat 1: MegadethChug (small blind) folded before Flop
Seat 2: dioclecio13 (big blind) collected (1180)
Seat 4: flagao (button) folded before Flop (didn't bet)



PokerStars Hand #189313680244: Tournament #2369778109, $0.23+$0.02 USD Hold'em No Limit - Level XII (500/1000) - 2018/07/29 22:19:00 ET
Table '2369778109 3' 9-max Seat #1 is the button
Seat 1: MegadethChug (11152 in chips) 
Seat 2: dioclecio13 (17844 in chips) 
Seat 4: flagao (38504 in chips) 
MegadethChug: posts the ante 60
dioclecio13: posts the ante 60
flagao: posts the ante 60
dioclecio13: posts small blind 500
flagao: posts big blind 1000
*** HOLE CARDS ***
Dealt to flagao [Ad Kc]
MegadethChug: folds 
dioclecio13: calls 500
flagao: raises 2000 to 3000
dioclecio13: calls 2000
*** FLOP *** [7d Jh 4s]
dioclecio13: checks 
flagao: bets 4000
dioclecio13: raises 10784 to 14784 and is all-in
flagao: folds 
Uncalled bet (10784) returned to dioclecio13
dioclecio13 collected 14180 from pot
dioclecio13: doesn't show hand 
*** SUMMARY ***
Total pot 14180 | Rake 0 
Board [7d Jh 4s]
Seat 1: MegadethChug (button) folded before Flop (didn't bet)
Seat 2: dioclecio13 (small blind) collected (14180)
Seat 4: flagao (big blind) folded on the Flop



PokerStars Hand #189313691126: Tournament #2369778109, $0.23+$0.02 USD Hold'em No Limit - Level XII (500/1000) - 2018/07/29 22:19:35 ET
Table '2369778109 3' 9-max Seat #2 is the button
Seat 1: MegadethChug (11092 in chips) 
Seat 2: dioclecio13 (24964 in chips) 
Seat 4: flagao (31444 in chips) 
MegadethChug: posts the ante 60
dioclecio13: posts the ante 60
flagao: posts the ante 60
flagao: posts small blind 500
MegadethChug: posts big blind 1000
*** HOLE CARDS ***
Dealt to flagao [Ac Ah]
dioclecio13: folds 
flagao: raises 1500 to 2500
MegadethChug: folds 
Uncalled bet (1500) returned to flagao
flagao collected 2180 from pot
flagao: doesn't show hand 
*** SUMMARY ***
Total pot 2180 | Rake 0 
Seat 1: MegadethChug (big blind) folded before Flop
Seat 2: dioclecio13 (button) folded before Flop (didn't bet)
Seat 4: flagao (small blind) collected (2180)



PokerStars Hand #189313695195: Tournament #2369778109, $0.23+$0.02 USD Hold'em No Limit - Level XII (500/1000) - 2018/07/29 22:19:49 ET
Table '2369778109 3' 9-max Seat #4 is the button
Seat 1: MegadethChug (10032 in chips) 
Seat 2: dioclecio13 (24904 in chips) 
Seat 4: flagao (32564 in chips) 
MegadethChug: posts the ante 60
dioclecio13: posts the ante 60
flagao: posts the ante 60
MegadethChug: posts small blind 500
dioclecio13: posts big blind 1000
*** HOLE CARDS ***
Dealt to flagao [8c 9s]
flagao: folds 
MegadethChug: calls 500
dioclecio13: checks 
*** FLOP *** [7d 6h 3c]
MegadethChug: checks 
dioclecio13: bets 1000
MegadethChug: folds 
Uncalled bet (1000) returned to dioclecio13
dioclecio13 collected 2180 from pot
dioclecio13: doesn't show hand 
*** SUMMARY ***
Total pot 2180 | Rake 0 
Board [7d 6h 3c]
Seat 1: MegadethChug (small blind) folded on the Flop
Seat 2: dioclecio13 (big blind) collected (2180)
Seat 4: flagao (button) folded before Flop (didn't bet)



PokerStars Hand #189313705299: Tournament #2369778109, $0.23+$0.02 USD Hold'em No Limit - Level XII (500/1000) - 2018/07/29 22:20:13 ET
Table '2369778109 3' 9-max Seat #1 is the button
Seat 1: MegadethChug (8972 in chips) 
Seat 2: dioclecio13 (26024 in chips) 
Seat 4: flagao (32504 in chips) 
MegadethChug: posts the ante 60
dioclecio13: posts the ante 60
flagao: posts the ante 60
dioclecio13: posts small blind 500
flagao: posts big blind 1000
*** HOLE CARDS ***
Dealt to flagao [Ks 4c]
MegadethChug: folds 
dioclecio13: raises 1000 to 2000
flagao: folds 
Uncalled bet (1000) returned to dioclecio13
dioclecio13 collected 2180 from pot
dioclecio13: doesn't show hand 
*** SUMMARY ***
Total pot 2180 | Rake 0 
Seat 1: MegadethChug (button) folded before Flop (didn't bet)
Seat 2: dioclecio13 (small blind) collected (2180)
Seat 4: flagao (big blind) folded before Flop



PokerStars Hand #189313708889: Tournament #2369778109, $0.23+$0.02 USD Hold'em No Limit - Level XII (500/1000) - 2018/07/29 22:20:24 ET
Table '2369778109 3' 9-max Seat #2 is the button
Seat 1: MegadethChug (8912 in chips) 
Seat 2: dioclecio13 (27144 in chips) 
Seat 4: flagao (31444 in chips) 
MegadethChug: posts the ante 60
dioclecio13: posts the ante 60
flagao: posts the ante 60
flagao: posts small blind 500
MegadethChug: posts big blind 1000
*** HOLE CARDS ***
Dealt to flagao [Qh 5h]
dioclecio13: calls 1000
flagao: raises 2000 to 3000
MegadethChug: folds 
dioclecio13: raises 24084 to 27084 and is all-in
flagao: folds 
Uncalled bet (24084) returned to dioclecio13
dioclecio13 collected 7180 from pot
dioclecio13: doesn't show hand 
*** SUMMARY ***
Total pot 7180 | Rake 0 
Seat 1: MegadethChug (big blind) folded before Flop
Seat 2: dioclecio13 (button) collected (7180)
Seat 4: flagao (small blind) folded before Flop



PokerStars Hand #189313715456: Tournament #2369778109, $0.23+$0.02 USD Hold'em No Limit - Level XII (500/1000) - 2018/07/29 22:20:46 ET
Table '2369778109 3' 9-max Seat #4 is the button
Seat 1: MegadethChug (7852 in chips) 
Seat 2: dioclecio13 (31264 in chips) 
Seat 4: flagao (28384 in chips) 
MegadethChug: posts the ante 60
dioclecio13: posts the ante 60
flagao: posts the ante 60
MegadethChug: posts small blind 500
dioclecio13: posts big blind 1000
*** HOLE CARDS ***
Dealt to flagao [3d 4c]
flagao: folds 
MegadethChug: raises 6792 to 7792 and is all-in
dioclecio13: folds 
Uncalled bet (6792) returned to MegadethChug
MegadethChug collected 2180 from pot
*** SUMMARY ***
Total pot 2180 | Rake 0 
Seat 1: MegadethChug (small blind) collected (2180)
Seat 2: dioclecio13 (big blind) folded before Flop
Seat 4: flagao (button) folded before Flop (didn't bet)



PokerStars Hand #189313719364: Tournament #2369778109, $0.23+$0.02 USD Hold'em No Limit - Level XII (500/1000) - 2018/07/29 22:20:59 ET
Table '2369778109 3' 9-max Seat #1 is the button
Seat 1: MegadethChug (8972 in chips) 
Seat 2: dioclecio13 (30204 in chips) 
Seat 4: flagao (28324 in chips) 
MegadethChug: posts the ante 60
dioclecio13: posts the ante 60
flagao: posts the ante 60
dioclecio13: posts small blind 500
flagao: posts big blind 1000
*** HOLE CARDS ***
Dealt to flagao [6s Ah]
MegadethChug: folds 
dioclecio13: calls 500
flagao: checks 
*** FLOP *** [8d Ts 3d]
dioclecio13: checks 
flagao: checks 
*** TURN *** [8d Ts 3d] [8h]
dioclecio13: checks 
flagao: checks 
*** RIVER *** [8d Ts 3d 8h] [6c]
dioclecio13: checks 
flagao: bets 2000
dioclecio13: calls 2000
*** SHOW DOWN ***
flagao: shows [6s Ah] (two pair, Eights and Sixes)
dioclecio13: mucks hand 
flagao collected 6180 from pot
*** SUMMARY ***
Total pot 6180 | Rake 0 
Board [8d Ts 3d 8h 6c]
Seat 1: MegadethChug (button) folded before Flop (didn't bet)
Seat 2: dioclecio13 (small blind) mucked [7h 6d]
Seat 4: flagao (big blind) showed [6s Ah] and won (6180) with two pair, Eights and Sixes



PokerStars Hand #189313734904: Tournament #2369778109, $0.23+$0.02 USD Hold'em No Limit - Level XII (500/1000) - 2018/07/29 22:21:50 ET
Table '2369778109 3' 9-max Seat #2 is the button
Seat 1: MegadethChug (8912 in chips) 
Seat 2: dioclecio13 (27144 in chips) 
Seat 4: flagao (31444 in chips) 
MegadethChug: posts the ante 60
dioclecio13: posts the ante 60
flagao: posts the ante 60
flagao: posts small blind 500
MegadethChug: posts big blind 1000
*** HOLE CARDS ***
Dealt to flagao [8s 7s]
dioclecio13: folds 
flagao: raises 1500 to 2500
MegadethChug: folds 
Uncalled bet (1500) returned to flagao
flagao collected 2180 from pot
flagao: doesn't show hand 
*** SUMMARY ***
Total pot 2180 | Rake 0 
Seat 1: MegadethChug (big blind) folded before Flop
Seat 2: dioclecio13 (button) folded before Flop (didn't bet)
Seat 4: flagao (small blind) collected (2180)



PokerStars Hand #189313739962: Tournament #2369778109, $0.23+$0.02 USD Hold'em No Limit - Level XII (500/1000) - 2018/07/29 22:22:07 ET
Table '2369778109 3' 9-max Seat #4 is the button
Seat 1: MegadethChug (7852 in chips) 
Seat 2: dioclecio13 (27084 in chips) 
Seat 4: flagao (32564 in chips) 
MegadethChug: posts the ante 60
dioclecio13: posts the ante 60
flagao: posts the ante 60
MegadethChug: posts small blind 500
dioclecio13: posts big blind 1000
*** HOLE CARDS ***
Dealt to flagao [Jc 3c]
flagao: folds 
MegadethChug: calls 500
dioclecio13: checks 
*** FLOP *** [3d Td Tc]
MegadethChug: checks 
dioclecio13: bets 1000
MegadethChug: raises 5792 to 6792 and is all-in
dioclecio13: calls 5792
*** TURN *** [3d Td Tc] [7c]
*** RIVER *** [3d Td Tc 7c] [4c]
*** SHOW DOWN ***
MegadethChug: shows [5h 3h] (two pair, Tens and Threes)
dioclecio13: shows [3s 2d] (two pair, Tens and Threes)
MegadethChug collected 7882 from pot
dioclecio13 collected 7882 from pot
*** SUMMARY ***
Total pot 15764 | Rake 0 
Board [3d Td Tc 7c 4c]
Seat 1: MegadethChug (small blind) showed [5h 3h] and won (7882) with two pair, Tens and Threes
Seat 2: dioclecio13 (big blind) showed [3s 2d] and won (7882) with two pair, Tens and Threes
Seat 4: flagao (button) folded before Flop (didn't bet)



PokerStars Hand #189313751608: Tournament #2369778109, $0.23+$0.02 USD Hold'em No Limit - Level XIII (600/1200) - 2018/07/29 22:22:45 ET
Table '2369778109 3' 9-max Seat #1 is the button
Seat 1: MegadethChug (7882 in chips) 
Seat 2: dioclecio13 (27114 in chips) 
Seat 4: flagao (32504 in chips) 
MegadethChug: posts the ante 75
dioclecio13: posts the ante 75
flagao: posts the ante 75
dioclecio13: posts small blind 600
flagao: posts big blind 1200
*** HOLE CARDS ***
Dealt to flagao [9d 8c]
MegadethChug: folds 
dioclecio13: raises 1200 to 2400
flagao: folds 
Uncalled bet (1200) returned to dioclecio13
dioclecio13 collected 2625 from pot
dioclecio13: doesn't show hand 
*** SUMMARY ***
Total pot 2625 | Rake 0 
Seat 1: MegadethChug (button) folded before Flop (didn't bet)
Seat 2: dioclecio13 (small blind) collected (2625)
Seat 4: flagao (big blind) folded before Flop



PokerStars Hand #189313755072: Tournament #2369778109, $0.23+$0.02 USD Hold'em No Limit - Level XIII (600/1200) - 2018/07/29 22:22:57 ET
Table '2369778109 3' 9-max Seat #2 is the button
Seat 1: MegadethChug (7807 in chips) 
Seat 2: dioclecio13 (28464 in chips) 
Seat 4: flagao (31229 in chips) 
MegadethChug: posts the ante 75
dioclecio13: posts the ante 75
flagao: posts the ante 75
flagao: posts small blind 600
MegadethChug: posts big blind 1200
*** HOLE CARDS ***
Dealt to flagao [2h 2s]
dioclecio13: folds 
flagao: raises 1800 to 3000
MegadethChug: folds 
Uncalled bet (1800) returned to flagao
flagao collected 2625 from pot
flagao: doesn't show hand 
*** SUMMARY ***
Total pot 2625 | Rake 0 
Seat 1: MegadethChug (big blind) folded before Flop
Seat 2: dioclecio13 (button) folded before Flop (didn't bet)
Seat 4: flagao (small blind) collected (2625)



PokerStars Hand #189313759917: Tournament #2369778109, $0.23+$0.02 USD Hold'em No Limit - Level XIII (600/1200) - 2018/07/29 22:23:13 ET
Table '2369778109 3' 9-max Seat #4 is the button
Seat 1: MegadethChug (6532 in chips) 
Seat 2: dioclecio13 (28389 in chips) 
Seat 4: flagao (32579 in chips) 
MegadethChug: posts the ante 75
dioclecio13: posts the ante 75
flagao: posts the ante 75
MegadethChug: posts small blind 600
dioclecio13: posts big blind 1200
*** HOLE CARDS ***
Dealt to flagao [6c 7s]
flagao: folds 
MegadethChug: folds 
Uncalled bet (600) returned to dioclecio13
dioclecio13 collected 1425 from pot
dioclecio13: doesn't show hand 
*** SUMMARY ***
Total pot 1425 | Rake 0 
Seat 1: MegadethChug (small blind) folded before Flop
Seat 2: dioclecio13 (big blind) collected (1425)
Seat 4: flagao (button) folded before Flop (didn't bet)



PokerStars Hand #189313762968: Tournament #2369778109, $0.23+$0.02 USD Hold'em No Limit - Level XIII (600/1200) - 2018/07/29 22:23:23 ET
Table '2369778109 3' 9-max Seat #1 is the button
Seat 1: MegadethChug (5857 in chips) 
Seat 2: dioclecio13 (29139 in chips) 
Seat 4: flagao (32504 in chips) 
MegadethChug: posts the ante 75
dioclecio13: posts the ante 75
flagao: posts the ante 75
dioclecio13: posts small blind 600
flagao: posts big blind 1200
*** HOLE CARDS ***
Dealt to flagao [Jd 4d]
MegadethChug: raises 4582 to 5782 and is all-in
dioclecio13: calls 5182
flagao: folds 
*** FLOP *** [8s 7d 5c]
*** TURN *** [8s 7d 5c] [Kc]
*** RIVER *** [8s 7d 5c Kc] [5h]
*** SHOW DOWN ***
dioclecio13: shows [Kd 5d] (a full house, Fives full of Kings)
MegadethChug: shows [8c 9c] (two pair, Eights and Fives)
dioclecio13 collected 12989 from pot
MegadethChug finished the tournament in 3rd place and received $1.70.
*** SUMMARY ***
Total pot 12989 | Rake 0 
Board [8s 7d 5c Kc 5h]
Seat 1: MegadethChug (button) showed [8c 9c] and lost with two pair, Eights and Fives
Seat 2: dioclecio13 (small blind) showed [Kd 5d] and won (12989) with a full house, Fives full of Kings
Seat 4: flagao (big blind) folded before Flop



PokerStars Hand #189313769717: Tournament #2369778109, $0.23+$0.02 USD Hold'em No Limit - Level XIII (600/1200) - 2018/07/29 22:23:45 ET
Table '2369778109 3' 9-max Seat #4 is the button
Seat 2: dioclecio13 (36271 in chips) 
Seat 4: flagao (31229 in chips) 
dioclecio13: posts the ante 75
flagao: posts the ante 75
flagao: posts small blind 600
dioclecio13: posts big blind 1200
*** HOLE CARDS ***
Dealt to flagao [Ts 5c]
flagao: raises 1200 to 2400
dioclecio13: calls 1200
*** FLOP *** [7s 4h 9h]
dioclecio13: checks 
flagao: checks 
*** TURN *** [7s 4h 9h] [7h]
dioclecio13: checks 
flagao: checks 
*** RIVER *** [7s 4h 9h 7h] [4c]
dioclecio13: checks 
flagao: bets 3600
dioclecio13: calls 3600
*** SHOW DOWN ***
flagao: shows [Ts 5c] (two pair, Sevens and Fours)
dioclecio13: shows [Ad 2d] (two pair, Sevens and Fours - Ace kicker)
dioclecio13 collected 12150 from pot
*** SUMMARY ***
Total pot 12150 | Rake 0 
Board [7s 4h 9h 7h 4c]
Seat 2: dioclecio13 (big blind) showed [Ad 2d] and won (12150) with two pair, Sevens and Fours
Seat 4: flagao (button) (small blind) showed [Ts 5c] and lost with two pair, Sevens and Fours



PokerStars Hand #189313779613: Tournament #2369778109, $0.23+$0.02 USD Hold'em No Limit - Level XIII (600/1200) - 2018/07/29 22:24:18 ET
Table '2369778109 3' 9-max Seat #2 is the button
Seat 2: dioclecio13 (42346 in chips) 
Seat 4: flagao (25154 in chips) 
dioclecio13: posts the ante 75
flagao: posts the ante 75
dioclecio13: posts small blind 600
flagao: posts big blind 1200
*** HOLE CARDS ***
Dealt to flagao [3h Td]
dioclecio13: raises 1200 to 2400
flagao: folds 
Uncalled bet (1200) returned to dioclecio13
dioclecio13 collected 2550 from pot
dioclecio13: doesn't show hand 
*** SUMMARY ***
Total pot 2550 | Rake 0 
Seat 2: dioclecio13 (button) (small blind) collected (2550)
Seat 4: flagao (big blind) folded before Flop



PokerStars Hand #189313782208: Tournament #2369778109, $0.23+$0.02 USD Hold'em No Limit - Level XIII (600/1200) - 2018/07/29 22:24:26 ET
Table '2369778109 3' 9-max Seat #4 is the button
Seat 2: dioclecio13 (43621 in chips) 
Seat 4: flagao (23879 in chips) 
dioclecio13: posts the ante 75
flagao: posts the ante 75
flagao: posts small blind 600
dioclecio13: posts big blind 1200
*** HOLE CARDS ***
Dealt to flagao [Td Qd]
flagao: raises 1800 to 3000
dioclecio13: calls 1800
*** FLOP *** [8h 2s Jh]
dioclecio13: checks 
flagao: bets 4800
dioclecio13: folds 
Uncalled bet (4800) returned to flagao
flagao collected 6150 from pot
flagao: doesn't show hand 
*** SUMMARY ***
Total pot 6150 | Rake 0 
Board [8h 2s Jh]
Seat 2: dioclecio13 (big blind) folded on the Flop
Seat 4: flagao (button) (small blind) collected (6150)



PokerStars Hand #189313789580: Tournament #2369778109, $0.23+$0.02 USD Hold'em No Limit - Level XIII (600/1200) - 2018/07/29 22:24:51 ET
Table '2369778109 3' 9-max Seat #2 is the button
Seat 2: dioclecio13 (40546 in chips) 
Seat 4: flagao (26954 in chips) 
dioclecio13: posts the ante 75
flagao: posts the ante 75
dioclecio13: posts small blind 600
flagao: posts big blind 1200
*** HOLE CARDS ***
Dealt to flagao [7s 9c]
dioclecio13: calls 600
flagao: checks 
*** FLOP *** [8s 9h Kc]
flagao: checks 
dioclecio13: bets 1200
flagao: calls 1200
*** TURN *** [8s 9h Kc] [5s]
flagao: bets 3600
dioclecio13: folds 
Uncalled bet (3600) returned to flagao
flagao collected 4950 from pot
flagao: doesn't show hand 
*** SUMMARY ***
Total pot 4950 | Rake 0 
Board [8s 9h Kc 5s]
Seat 2: dioclecio13 (button) (small blind) folded on the Turn
Seat 4: flagao (big blind) collected (4950)



PokerStars Hand #189313798304: Tournament #2369778109, $0.23+$0.02 USD Hold'em No Limit - Level XIII (600/1200) - 2018/07/29 22:25:20 ET
Table '2369778109 3' 9-max Seat #4 is the button
Seat 2: dioclecio13 (38071 in chips) 
Seat 4: flagao (29429 in chips) 
dioclecio13: posts the ante 75
flagao: posts the ante 75
flagao: posts small blind 600
dioclecio13: posts big blind 1200
*** HOLE CARDS ***
Dealt to flagao [3c Kh]
flagao: raises 1200 to 2400
dioclecio13: raises 35596 to 37996 and is all-in
flagao: folds 
Uncalled bet (35596) returned to dioclecio13
dioclecio13 collected 4950 from pot
dioclecio13: doesn't show hand 
*** SUMMARY ***
Total pot 4950 | Rake 0 
Seat 2: dioclecio13 (big blind) collected (4950)
Seat 4: flagao (button) (small blind) folded before Flop



PokerStars Hand #189313802328: Tournament #2369778109, $0.23+$0.02 USD Hold'em No Limit - Level XIII (600/1200) - 2018/07/29 22:25:33 ET
Table '2369778109 3' 9-max Seat #2 is the button
Seat 2: dioclecio13 (40546 in chips) 
Seat 4: flagao (26954 in chips) 
dioclecio13: posts the ante 75
flagao: posts the ante 75
dioclecio13: posts small blind 600
flagao: posts big blind 1200
*** HOLE CARDS ***
Dealt to flagao [7s Kd]
dioclecio13: calls 600
flagao: checks 
*** FLOP *** [8c 4d 6s]
flagao: bets 2400
dioclecio13: folds 
Uncalled bet (2400) returned to flagao
flagao collected 2550 from pot
flagao: doesn't show hand 
*** SUMMARY ***
Total pot 2550 | Rake 0 
Board [8c 4d 6s]
Seat 2: dioclecio13 (button) (small blind) folded on the Flop
Seat 4: flagao (big blind) collected (2550)



PokerStars Hand #189313807207: Tournament #2369778109, $0.23+$0.02 USD Hold'em No Limit - Level XIII (600/1200) - 2018/07/29 22:25:50 ET
Table '2369778109 3' 9-max Seat #4 is the button
Seat 2: dioclecio13 (39271 in chips) 
Seat 4: flagao (28229 in chips) 
dioclecio13: posts the ante 75
flagao: posts the ante 75
flagao: posts small blind 600
dioclecio13: posts big blind 1200
*** HOLE CARDS ***
Dealt to flagao [5d 4c]
flagao: folds 
Uncalled bet (600) returned to dioclecio13
dioclecio13 collected 1350 from pot
dioclecio13: doesn't show hand 
*** SUMMARY ***
Total pot 1350 | Rake 0 
Seat 2: dioclecio13 (big blind) collected (1350)
Seat 4: flagao (button) (small blind) folded before Flop



PokerStars Hand #189313809260: Tournament #2369778109, $0.23+$0.02 USD Hold'em No Limit - Level XIII (600/1200) - 2018/07/29 22:25:56 ET
Table '2369778109 3' 9-max Seat #2 is the button
Seat 2: dioclecio13 (39946 in chips) 
Seat 4: flagao (27554 in chips) 
dioclecio13: posts the ante 75
flagao: posts the ante 75
dioclecio13: posts small blind 600
flagao: posts big blind 1200
*** HOLE CARDS ***
Dealt to flagao [8c Kc]
dioclecio13: raises 1200 to 2400
flagao: raises 25079 to 27479 and is all-in
dioclecio13: folds 
Uncalled bet (25079) returned to flagao
flagao collected 4950 from pot
flagao: doesn't show hand 
*** SUMMARY ***
Total pot 4950 | Rake 0 
Seat 2: dioclecio13 (button) (small blind) folded before Flop
Seat 4: flagao (big blind) collected (4950)



PokerStars Hand #189313813449: Tournament #2369778109, $0.23+$0.02 USD Hold'em No Limit - Level XIII (600/1200) - 2018/07/29 22:26:10 ET
Table '2369778109 3' 9-max Seat #4 is the button
Seat 2: dioclecio13 (37471 in chips) 
Seat 4: flagao (30029 in chips) 
dioclecio13: posts the ante 75
flagao: posts the ante 75
flagao: posts small blind 600
dioclecio13: posts big blind 1200
*** HOLE CARDS ***
Dealt to flagao [8c Qc]
flagao: raises 1200 to 2400
dioclecio13: calls 1200
*** FLOP *** [Td Kc 6s]
dioclecio13: checks 
flagao: bets 3600
dioclecio13: folds 
Uncalled bet (3600) returned to flagao
flagao collected 4950 from pot
flagao: doesn't show hand 
*** SUMMARY ***
Total pot 4950 | Rake 0 
Board [Td Kc 6s]
Seat 2: dioclecio13 (big blind) folded on the Flop
Seat 4: flagao (button) (small blind) collected (4950)



PokerStars Hand #189313819661: Tournament #2369778109, $0.23+$0.02 USD Hold'em No Limit - Level XIII (600/1200) - 2018/07/29 22:26:31 ET
Table '2369778109 3' 9-max Seat #2 is the button
Seat 2: dioclecio13 (34996 in chips) 
Seat 4: flagao (32504 in chips) 
dioclecio13: posts the ante 75
flagao: posts the ante 75
dioclecio13: posts small blind 600
flagao: posts big blind 1200
*** HOLE CARDS ***
Dealt to flagao [9s 8c]
dioclecio13: calls 600
flagao: checks 
*** FLOP *** [Ts 9h 4c]
flagao: bets 2400
dioclecio13: calls 2400
*** TURN *** [Ts 9h 4c] [3d]
flagao: bets 6000
dioclecio13: raises 25321 to 31321 and is all-in
flagao: folds 
Uncalled bet (25321) returned to dioclecio13
dioclecio13 collected 19350 from pot
dioclecio13: doesn't show hand 
*** SUMMARY ***
Total pot 19350 | Rake 0 
Board [Ts 9h 4c 3d]
Seat 2: dioclecio13 (button) (small blind) collected (19350)
Seat 4: flagao (big blind) folded on the Turn



PokerStars Hand #189313828386: Tournament #2369778109, $0.23+$0.02 USD Hold'em No Limit - Level XIII (600/1200) - 2018/07/29 22:27:00 ET
Table '2369778109 3' 9-max Seat #4 is the button
Seat 2: dioclecio13 (44671 in chips) 
Seat 4: flagao (22829 in chips) 
dioclecio13: posts the ante 75
flagao: posts the ante 75
flagao: posts small blind 600
dioclecio13: posts big blind 1200
*** HOLE CARDS ***
Dealt to flagao [As 2s]
flagao: raises 1200 to 2400
dioclecio13: calls 1200
*** FLOP *** [9s Ac 8d]
dioclecio13: checks 
flagao: checks 
*** TURN *** [9s Ac 8d] [5h]
dioclecio13: checks 
flagao: bets 3600
dioclecio13: calls 3600
*** RIVER *** [9s Ac 8d 5h] [4d]
dioclecio13: bets 10692
flagao: raises 6062 to 16754 and is all-in
dioclecio13: folds 
Uncalled bet (6062) returned to flagao
flagao collected 33534 from pot
flagao: doesn't show hand 
*** SUMMARY ***
Total pot 33534 | Rake 0 
Board [9s Ac 8d 5h 4d]
Seat 2: dioclecio13 (big blind) folded on the River
Seat 4: flagao (button) (small blind) collected (33534)



PokerStars Hand #189313841561: Tournament #2369778109, $0.23+$0.02 USD Hold'em No Limit - Level XIII (600/1200) - 2018/07/29 22:27:44 ET
Table '2369778109 3' 9-max Seat #2 is the button
Seat 2: dioclecio13 (27904 in chips) 
Seat 4: flagao (39596 in chips) 
dioclecio13: posts the ante 75
flagao: posts the ante 75
dioclecio13: posts small blind 600
flagao: posts big blind 1200
*** HOLE CARDS ***
Dealt to flagao [6h 7c]
dioclecio13: raises 1200 to 2400
flagao: calls 1200
*** FLOP *** [Jc As 9s]
flagao: bets 3600
dioclecio13: raises 21829 to 25429 and is all-in
flagao: folds 
Uncalled bet (21829) returned to dioclecio13
dioclecio13 collected 12150 from pot
dioclecio13: doesn't show hand 
*** SUMMARY ***
Total pot 12150 | Rake 0 
Board [Jc As 9s]
Seat 2: dioclecio13 (button) (small blind) collected (12150)
Seat 4: flagao (big blind) folded on the Flop



PokerStars Hand #189313848298: Tournament #2369778109, $0.23+$0.02 USD Hold'em No Limit - Level XIII (600/1200) - 2018/07/29 22:28:07 ET
Table '2369778109 3' 9-max Seat #4 is the button
Seat 2: dioclecio13 (33979 in chips) 
Seat 4: flagao (33521 in chips) 
dioclecio13: posts the ante 75
flagao: posts the ante 75
flagao: posts small blind 600
dioclecio13: posts big blind 1200
*** HOLE CARDS ***
Dealt to flagao [9c 6d]
flagao: folds 
Uncalled bet (600) returned to dioclecio13
dioclecio13 collected 1350 from pot
dioclecio13: doesn't show hand 
*** SUMMARY ***
Total pot 1350 | Rake 0 
Seat 2: dioclecio13 (big blind) collected (1350)
Seat 4: flagao (button) (small blind) folded before Flop



PokerStars Hand #189313850788: Tournament #2369778109, $0.23+$0.02 USD Hold'em No Limit - Level XIII (600/1200) - 2018/07/29 22:28:15 ET
Table '2369778109 3' 9-max Seat #2 is the button
Seat 2: dioclecio13 (34654 in chips) 
Seat 4: flagao (32846 in chips) 
dioclecio13: posts the ante 75
flagao: posts the ante 75
dioclecio13: posts small blind 600
flagao: posts big blind 1200
*** HOLE CARDS ***
Dealt to flagao [Kh Qd]
dioclecio13: raises 1200 to 2400
flagao: raises 30371 to 32771 and is all-in
dioclecio13: calls 30371
*** FLOP *** [Jh 2s 6c]
*** TURN *** [Jh 2s 6c] [6d]
*** RIVER *** [Jh 2s 6c 6d] [5d]
*** SHOW DOWN ***
flagao: shows [Kh Qd] (a pair of Sixes)
dioclecio13: shows [Ah 9h] (a pair of Sixes - Ace kicker)
dioclecio13 collected 65692 from pot
flagao finished the tournament in 2nd place and received $2.22.
dioclecio13 wins the tournament and receives $3.23 - congratulations!
*** SUMMARY ***
Total pot 65692 | Rake 0 
Board [Jh 2s 6c 6d 5d]
Seat 2: dioclecio13 (button) (small blind) showed [Ah 9h] and won (65692) with a pair of Sixes
Seat 4: flagao (big blind) showed [Kh Qd] and lost with a pair of Sixes


PokerStars Hand #189310862527: Tournament #2369778109, $0.23+$0.02 USD Hold'em No Limit - Level I (10/20) - 2018/07/29 20:11:28 ET
Table '2369778109 1' 9-max Seat #1 is the button
Seat 1: intelllect (1500 in chips) 
Seat 2: chaq*n voy (1500 in chips) 
Seat 3: flagao (1500 in chips) 
Seat 4: casttilho21 (1500 in chips) 
Seat 5: biroxadrez (1500 in chips) 
Seat 6: thiagoflauzi (1500 in chips) 
Seat 7: Paco Mechou (1500 in chips) 
Seat 8: rtrombin22 (1500 in chips) 
Seat 9: berilo.rama (1500 in chips) 
intelllect: posts the ante 3
chaq*n voy: posts the ante 3
flagao: posts the ante 3
casttilho21: posts the ante 3
biroxadrez: posts the ante 3
thiagoflauzi: posts the ante 3
Paco Mechou: posts the ante 3
rtrombin22: posts the ante 3
berilo.rama: posts the ante 3
chaq*n voy: posts small blind 10
flagao: posts big blind 20
*** HOLE CARDS ***
Dealt to flagao [Td 7h]
casttilho21: folds 
biroxadrez: folds 
thiagoflauzi: folds 
Paco Mechou: calls 20
rtrombin22: folds 
berilo.rama: calls 20
intelllect: calls 20
chaq*n voy: calls 10
flagao: checks 
*** FLOP *** [4d Qh 4h]
chaq*n voy: checks 
flagao: checks 
Paco Mechou: checks 
berilo.rama: checks 
intelllect: checks 
*** TURN *** [4d Qh 4h] [Kd]
chaq*n voy: checks 
flagao: checks 
Paco Mechou: bets 40
berilo.rama: folds 
intelllect: folds 
chaq*n voy: folds 
flagao: folds 
Uncalled bet (40) returned to Paco Mechou
Paco Mechou collected 127 from pot
Paco Mechou: doesn't show hand 
*** SUMMARY ***
Total pot 127 | Rake 0 
Board [4d Qh 4h Kd]
Seat 1: intelllect (button) folded on the Turn
Seat 2: chaq*n voy (small blind) folded on the Turn
Seat 3: flagao (big blind) folded on the Turn
Seat 4: casttilho21 folded before Flop (didn't bet)
Seat 5: biroxadrez folded before Flop (didn't bet)
Seat 6: thiagoflauzi folded before Flop (didn't bet)
Seat 7: Paco Mechou collected (127)
Seat 8: rtrombin22 folded before Flop (didn't bet)
Seat 9: berilo.rama folded on the Turn



