﻿﻿PokerStars Home Game Hand #211086024695: {Club #3217684} Tournament #2845705715, 17000+3000 Hold'em No Limit - Level I (15/30) - 2020/03/31 20:30:02 ET
Table '2845705715 1' 9-max Seat #1 is the button
Seat 1: FeGodines (10000 in chips) 
Seat 2: flagao (10000 in chips) 
Seat 3: SBocha (10000 in chips) 
Seat 4: Caduzzaum (10000 in chips) is sitting out
Seat 5: giovannifut (10000 in chips) 
Seat 6: fecomunale (10000 in chips) 
Seat 7: kinnho007 (10000 in chips) is sitting out
Seat 8: GreenMohawk88 (10000 in chips) is sitting out
flagao: posts small blind 15
SBocha: posts big blind 30
*** HOLE CARDS ***
Dealt to flagao [Ts 7h]
Caduzzaum: folds 
giovannifut: folds 
fecomunale: folds 
kinnho007: folds 
GreenMohawk88: folds 
FeGodines: raises 60 to 90
flagao: folds 
SBocha: calls 60
*** FLOP *** [As 9h 4c]
SBocha: checks 
FeGodines: bets 62
SBocha: folds 
Uncalled bet (62) returned to FeGodines
FeGodines collected 195 from pot
FeGodines: doesn't show hand 
*** SUMMARY ***
Total pot 195 | Rake 0 
Board [As 9h 4c]
Seat 1: FeGodines (button) collected (195)
Seat 2: flagao (small blind) folded before Flop
Seat 3: SBocha (big blind) folded on the Flop
Seat 4: Caduzzaum folded before Flop (didn't bet)
Seat 5: giovannifut folded before Flop (didn't bet)
Seat 6: fecomunale folded before Flop (didn't bet)
Seat 7: kinnho007 folded before Flop (didn't bet)
Seat 8: GreenMohawk88 folded before Flop (didn't bet)



PokerStars Home Game Hand #211086060072: {Club #3217684} Tournament #2845705715, 17000+3000 Hold'em No Limit - Level I (15/30) - 2020/03/31 20:30:55 ET
Table '2845705715 1' 9-max Seat #2 is the button
Seat 1: FeGodines (10105 in chips) 
Seat 2: flagao (9985 in chips) 
Seat 3: SBocha (9910 in chips) 
Seat 4: Caduzzaum (10000 in chips) is sitting out
Seat 5: giovannifut (10000 in chips) 
Seat 6: fecomunale (10000 in chips) 
Seat 7: kinnho007 (10000 in chips) is sitting out
Seat 8: GreenMohawk88 (10000 in chips) is sitting out
SBocha: posts small blind 15
Caduzzaum: posts big blind 30
*** HOLE CARDS ***
Dealt to flagao [3d 9d]
giovannifut: raises 60 to 90
fecomunale: folds 
kinnho007: folds 
GreenMohawk88: folds 
FeGodines: folds 
flagao: folds 
FeGodines is disconnected 
SBocha: folds 
Caduzzaum: folds 
Uncalled bet (60) returned to giovannifut
giovannifut collected 75 from pot
giovannifut: doesn't show hand 
*** SUMMARY ***
Total pot 75 | Rake 0 
Seat 1: FeGodines folded before Flop (didn't bet)
Seat 2: flagao (button) folded before Flop (didn't bet)
Seat 3: SBocha (small blind) folded before Flop
Seat 4: Caduzzaum (big blind) folded before Flop
Seat 5: giovannifut collected (75)
Seat 6: fecomunale folded before Flop (didn't bet)
Seat 7: kinnho007 folded before Flop (didn't bet)
Seat 8: GreenMohawk88 folded before Flop (didn't bet)



PokerStars Home Game Hand #211086086186: {Club #3217684} Tournament #2845705715, 17000+3000 Hold'em No Limit - Level I (15/30) - 2020/03/31 20:31:35 ET
Table '2845705715 1' 9-max Seat #3 is the button
Seat 1: FeGodines (10105 in chips) 
Seat 2: flagao (9985 in chips) 
Seat 3: SBocha (9895 in chips) 
Seat 4: Caduzzaum (9970 in chips) is sitting out
Seat 5: giovannifut (10045 in chips) 
Seat 6: fecomunale (10000 in chips) 
Seat 7: kinnho007 (10000 in chips) is sitting out
Seat 8: GreenMohawk88 (10000 in chips) is sitting out
Caduzzaum: posts small blind 15
giovannifut: posts big blind 30
*** HOLE CARDS ***
Dealt to flagao [Ks 9s]
fecomunale: folds 
kinnho007: folds 
GreenMohawk88: folds 
FeGodines has timed out while disconnected
FeGodines: folds 
flagao: raises 60 to 90
SBocha: calls 90
Caduzzaum: calls 75
giovannifut: folds 
*** FLOP *** [6c 9d Td]
Caduzzaum: checks 
flagao: bets 90
SBocha: calls 90
Caduzzaum: calls 90
*** TURN *** [6c 9d Td] [6s]
Caduzzaum: checks 
flagao: checks 
SBocha: checks 
*** RIVER *** [6c 9d Td 6s] [8c]
Caduzzaum: checks 
flagao: bets 150
SBocha: calls 150
Caduzzaum: raises 300 to 450
flagao: folds 
SBocha: folds 
Uncalled bet (300) returned to Caduzzaum
Caduzzaum collected 1020 from pot
Caduzzaum: doesn't show hand 
*** SUMMARY ***
Total pot 1020 | Rake 0 
Board [6c 9d Td 6s 8c]
Seat 1: FeGodines folded before Flop (didn't bet)
Seat 2: flagao folded on the River
Seat 3: SBocha (button) folded on the River
Seat 4: Caduzzaum (small blind) collected (1020)
Seat 5: giovannifut (big blind) folded before Flop
Seat 6: fecomunale folded before Flop (didn't bet)
Seat 7: kinnho007 folded before Flop (didn't bet)
Seat 8: GreenMohawk88 folded before Flop (didn't bet)



PokerStars Home Game Hand #211086154294: {Club #3217684} Tournament #2845705715, 17000+3000 Hold'em No Limit - Level I (15/30) - 2020/03/31 20:33:14 ET
Table '2845705715 1' 9-max Seat #4 is the button
Seat 1: FeGodines (10105 in chips) 
Seat 2: flagao (9655 in chips) 
Seat 3: SBocha (9565 in chips) 
Seat 4: Caduzzaum (10660 in chips) 
Seat 5: giovannifut (10015 in chips) 
Seat 6: fecomunale (10000 in chips) 
Seat 7: kinnho007 (10000 in chips) is sitting out
Seat 8: GreenMohawk88 (10000 in chips) is sitting out
Seat 9: h_liminha (10000 in chips) 
giovannifut: posts small blind 15
fecomunale: posts big blind 30
*** HOLE CARDS ***
Dealt to flagao [8d 4c]
kinnho007: folds 
GreenMohawk88: folds 
h_liminha: folds 
FeGodines: raises 60 to 90
flagao: folds 
SBocha: calls 90
Caduzzaum: folds 
giovannifut: folds 
fecomunale: folds 
*** FLOP *** [Ts Td 3h]
FeGodines: checks 
SBocha: checks 
*** TURN *** [Ts Td 3h] [Kh]
FeGodines: checks 
SBocha: bets 30
FeGodines: folds 
Uncalled bet (30) returned to SBocha
SBocha collected 225 from pot
SBocha: doesn't show hand 
*** SUMMARY ***
Total pot 225 | Rake 0 
Board [Ts Td 3h Kh]
Seat 1: FeGodines folded on the Turn
Seat 2: flagao folded before Flop (didn't bet)
Seat 3: SBocha collected (225)
Seat 4: Caduzzaum (button) folded before Flop (didn't bet)
Seat 5: giovannifut (small blind) folded before Flop
Seat 6: fecomunale (big blind) folded before Flop
Seat 7: kinnho007 folded before Flop (didn't bet)
Seat 8: GreenMohawk88 folded before Flop (didn't bet)
Seat 9: h_liminha folded before Flop (didn't bet)



PokerStars Home Game Hand #211086181433: {Club #3217684} Tournament #2845705715, 17000+3000 Hold'em No Limit - Level I (15/30) - 2020/03/31 20:33:55 ET
Table '2845705715 1' 9-max Seat #5 is the button
Seat 1: FeGodines (10015 in chips) 
Seat 2: flagao (9655 in chips) 
Seat 3: SBocha (9700 in chips) 
Seat 4: Caduzzaum (10660 in chips) 
Seat 5: giovannifut (10000 in chips) 
Seat 6: fecomunale (9970 in chips) 
Seat 7: kinnho007 (10000 in chips) is sitting out
Seat 8: GreenMohawk88 (10000 in chips) is sitting out
Seat 9: h_liminha (10000 in chips) 
fecomunale: posts small blind 15
kinnho007: posts big blind 30
*** HOLE CARDS ***
Dealt to flagao [3s As]
GreenMohawk88: folds 
h_liminha: folds 
FeGodines: folds 
flagao: raises 60 to 90
SBocha: folds 
Caduzzaum: calls 90
giovannifut: folds 
fecomunale: folds 
kinnho007: folds 
*** FLOP *** [4d 9c Tc]
flagao: checks 
Caduzzaum: bets 150
flagao: calls 150
*** TURN *** [4d 9c Tc] [8s]
flagao: checks 
Caduzzaum: bets 150
flagao: calls 150
*** RIVER *** [4d 9c Tc 8s] [7s]
flagao: bets 360
Caduzzaum: raises 360 to 720
flagao: folds 
Uncalled bet (360) returned to Caduzzaum
Caduzzaum collected 1545 from pot
Caduzzaum: doesn't show hand 
*** SUMMARY ***
Total pot 1545 | Rake 0 
Board [4d 9c Tc 8s 7s]
Seat 1: FeGodines folded before Flop (didn't bet)
Seat 2: flagao folded on the River
Seat 3: SBocha folded before Flop (didn't bet)
Seat 4: Caduzzaum collected (1545)
Seat 5: giovannifut (button) folded before Flop (didn't bet)
Seat 6: fecomunale (small blind) folded before Flop
Seat 7: kinnho007 (big blind) folded before Flop
Seat 8: GreenMohawk88 folded before Flop (didn't bet)
Seat 9: h_liminha folded before Flop (didn't bet)



PokerStars Home Game Hand #211086258073: {Club #3217684} Tournament #2845705715, 17000+3000 Hold'em No Limit - Level I (15/30) - 2020/03/31 20:35:37 ET
Table '2845705715 1' 9-max Seat #6 is the button
Seat 1: FeGodines (10015 in chips) 
Seat 2: flagao (8905 in chips) 
Seat 3: SBocha (9700 in chips) 
Seat 4: Caduzzaum (11455 in chips) 
Seat 5: giovannifut (10000 in chips) 
Seat 6: fecomunale (9955 in chips) 
Seat 7: kinnho007 (9970 in chips) is sitting out
Seat 8: GreenMohawk88 (10000 in chips) is sitting out
Seat 9: h_liminha (10000 in chips) 
kinnho007: posts small blind 15
GreenMohawk88: posts big blind 30
*** HOLE CARDS ***
Dealt to flagao [5s Kh]
h_liminha: folds 
FeGodines: folds 
flagao: folds 
SBocha: folds 
Caduzzaum: folds 
giovannifut: raises 60 to 90
fecomunale: folds 
kinnho007: folds 
GreenMohawk88: folds 
Uncalled bet (60) returned to giovannifut
giovannifut collected 75 from pot
giovannifut: doesn't show hand 
*** SUMMARY ***
Total pot 75 | Rake 0 
Seat 1: FeGodines folded before Flop (didn't bet)
Seat 2: flagao folded before Flop (didn't bet)
Seat 3: SBocha folded before Flop (didn't bet)
Seat 4: Caduzzaum folded before Flop (didn't bet)
Seat 5: giovannifut collected (75)
Seat 6: fecomunale (button) folded before Flop (didn't bet)
Seat 7: kinnho007 (small blind) folded before Flop
Seat 8: GreenMohawk88 (big blind) folded before Flop
Seat 9: h_liminha folded before Flop (didn't bet)



PokerStars Home Game Hand #211086275044: {Club #3217684} Tournament #2845705715, 17000+3000 Hold'em No Limit - Level I (15/30) - 2020/03/31 20:36:03 ET
Table '2845705715 1' 9-max Seat #7 is the button
Seat 1: FeGodines (10015 in chips) 
Seat 2: flagao (8905 in chips) 
Seat 3: SBocha (9700 in chips) 
Seat 4: Caduzzaum (11455 in chips) 
Seat 5: giovannifut (10045 in chips) 
Seat 6: fecomunale (9955 in chips) 
Seat 7: kinnho007 (9955 in chips) is sitting out
Seat 8: GreenMohawk88 (9970 in chips) is sitting out
Seat 9: h_liminha (10000 in chips) 
GreenMohawk88: posts small blind 15
h_liminha: posts big blind 30
*** HOLE CARDS ***
Dealt to flagao [2c Qh]
FeGodines: folds 
flagao: folds 
SBocha: folds 
Caduzzaum: calls 30
giovannifut: calls 30
fecomunale: folds 
kinnho007: folds 
GreenMohawk88: folds 
h_liminha: checks 
*** FLOP *** [Qs 4d 8s]
h_liminha: checks 
Caduzzaum: checks 
giovannifut: bets 90
h_liminha: folds 
Caduzzaum: calls 90
*** TURN *** [Qs 4d 8s] [4c]
Caduzzaum: checks 
giovannifut: checks 
*** RIVER *** [Qs 4d 8s 4c] [Qc]
Caduzzaum: checks 
giovannifut: checks 
*** SHOW DOWN ***
Caduzzaum: shows [8c Kd] (two pair, Queens and Eights)
giovannifut: mucks hand 
Caduzzaum collected 285 from pot
*** SUMMARY ***
Total pot 285 | Rake 0 
Board [Qs 4d 8s 4c Qc]
Seat 1: FeGodines folded before Flop (didn't bet)
Seat 2: flagao folded before Flop (didn't bet)
Seat 3: SBocha folded before Flop (didn't bet)
Seat 4: Caduzzaum showed [8c Kd] and won (285) with two pair, Queens and Eights
Seat 5: giovannifut mucked [Jd 8h]
Seat 6: fecomunale folded before Flop (didn't bet)
Seat 7: kinnho007 (button) folded before Flop (didn't bet)
Seat 8: GreenMohawk88 (small blind) folded before Flop
Seat 9: h_liminha (big blind) folded on the Flop



PokerStars Home Game Hand #211086326640: {Club #3217684} Tournament #2845705715, 17000+3000 Hold'em No Limit - Level I (15/30) - 2020/03/31 20:37:22 ET
Table '2845705715 1' 9-max Seat #8 is the button
Seat 1: FeGodines (10015 in chips) 
Seat 2: flagao (8905 in chips) 
Seat 3: SBocha (9700 in chips) 
Seat 4: Caduzzaum (11620 in chips) 
Seat 5: giovannifut (9925 in chips) 
Seat 6: fecomunale (9955 in chips) 
Seat 7: kinnho007 (9955 in chips) is sitting out
Seat 8: GreenMohawk88 (9955 in chips) is sitting out
Seat 9: h_liminha (9970 in chips) 
h_liminha: posts small blind 15
FeGodines: posts big blind 30
*** HOLE CARDS ***
Dealt to flagao [8d Js]
flagao: folds 
SBocha: calls 30
Caduzzaum: raises 30 to 60
giovannifut: folds 
fecomunale: folds 
kinnho007: folds 
GreenMohawk88: folds 
h_liminha: folds 
FeGodines: calls 30
SBocha: calls 30
*** FLOP *** [9h 6s 3d]
FeGodines: checks 
SBocha: checks 
Caduzzaum: checks 
*** TURN *** [9h 6s 3d] [5s]
FeGodines: checks 
SBocha: checks 
Caduzzaum: checks 
*** RIVER *** [9h 6s 3d 5s] [2d]
FeGodines: checks 
SBocha: checks 
Caduzzaum: checks 
*** SHOW DOWN ***
FeGodines: shows [Jc 6c] (a pair of Sixes)
SBocha: mucks hand 
Caduzzaum: mucks hand 
FeGodines collected 195 from pot
*** SUMMARY ***
Total pot 195 | Rake 0 
Board [9h 6s 3d 5s 2d]
Seat 1: FeGodines (big blind) showed [Jc 6c] and won (195) with a pair of Sixes
Seat 2: flagao folded before Flop (didn't bet)
Seat 3: SBocha mucked [Tc Kh]
Seat 4: Caduzzaum mucked [Ts Ah]
Seat 5: giovannifut folded before Flop (didn't bet)
Seat 6: fecomunale folded before Flop (didn't bet)
Seat 7: kinnho007 folded before Flop (didn't bet)
Seat 8: GreenMohawk88 (button) folded before Flop (didn't bet)
Seat 9: h_liminha (small blind) folded before Flop



PokerStars Home Game Hand #211086393249: {Club #3217684} Tournament #2845705715, 17000+3000 Hold'em No Limit - Level I (15/30) - 2020/03/31 20:38:54 ET
Table '2845705715 1' 9-max Seat #9 is the button
Seat 1: FeGodines (10150 in chips) 
Seat 2: flagao (8905 in chips) 
Seat 3: SBocha (9640 in chips) 
Seat 4: Caduzzaum (11560 in chips) 
Seat 5: giovannifut (9925 in chips) 
Seat 6: fecomunale (9955 in chips) 
Seat 7: kinnho007 (9955 in chips) 
Seat 8: GreenMohawk88 (9955 in chips) is sitting out
Seat 9: h_liminha (9955 in chips) 
FeGodines: posts small blind 15
flagao: posts big blind 30
*** HOLE CARDS ***
Dealt to flagao [Jh 6h]
SBocha: calls 30
Caduzzaum: folds 
giovannifut: folds 
fecomunale: calls 30
kinnho007: calls 30
GreenMohawk88: folds 
h_liminha: folds 
FeGodines: calls 15
flagao: checks 
*** FLOP *** [Ah 7c As]
FeGodines: checks 
flagao: checks 
SBocha: checks 
fecomunale: checks 
kinnho007: bets 30
FeGodines: calls 30
flagao: calls 30
SBocha: calls 30
fecomunale: calls 30
*** TURN *** [Ah 7c As] [2s]
FeGodines: checks 
flagao: checks 
SBocha: checks 
fecomunale: bets 150
kinnho007: calls 150
FeGodines: folds 
flagao: folds 
SBocha: folds 
*** RIVER *** [Ah 7c As 2s] [2c]
fecomunale: bets 300
kinnho007: raises 1200 to 1500
fecomunale: calls 1200
*** SHOW DOWN ***
kinnho007: shows [Ad 7h] (a full house, Aces full of Sevens)
fecomunale: mucks hand 
kinnho007 collected 3600 from pot
*** SUMMARY ***
Total pot 3600 | Rake 0 
Board [Ah 7c As 2s 2c]
Seat 1: FeGodines (small blind) folded on the Turn
Seat 2: flagao (big blind) folded on the Turn
Seat 3: SBocha folded on the Turn
Seat 4: Caduzzaum folded before Flop (didn't bet)
Seat 5: giovannifut folded before Flop (didn't bet)
Seat 6: fecomunale mucked [8d Ac]
Seat 7: kinnho007 showed [Ad 7h] and won (3600) with a full house, Aces full of Sevens
Seat 8: GreenMohawk88 folded before Flop (didn't bet)
Seat 9: h_liminha (button) folded before Flop (didn't bet)



PokerStars Home Game Hand #211086461251: {Club #3217684} Tournament #2845705715, 17000+3000 Hold'em No Limit - Level II (20/40) - 2020/03/31 20:40:39 ET
Table '2845705715 1' 9-max Seat #1 is the button
Seat 1: FeGodines (10090 in chips) 
Seat 2: flagao (8845 in chips) 
Seat 3: SBocha (9580 in chips) 
Seat 4: Caduzzaum (11560 in chips) 
Seat 5: giovannifut (9925 in chips) 
Seat 6: fecomunale (8245 in chips) 
Seat 7: kinnho007 (11845 in chips) 
Seat 8: GreenMohawk88 (9955 in chips) is sitting out
Seat 9: h_liminha (9955 in chips) 
flagao: posts small blind 20
SBocha: posts big blind 40
*** HOLE CARDS ***
Dealt to flagao [7c Qh]
Caduzzaum: folds 
giovannifut: folds 
fecomunale: folds 
kinnho007: raises 80 to 120
GreenMohawk88: folds 
h_liminha: folds 
FeGodines: folds 
flagao: folds 
SBocha: calls 80
*** FLOP *** [4c 8s 9s]
SBocha: checks 
kinnho007: checks 
*** TURN *** [4c 8s 9s] [3c]
SBocha: checks 
kinnho007: checks 
*** RIVER *** [4c 8s 9s 3c] [8c]
SBocha: checks 
kinnho007: bets 130
SBocha: folds 
Uncalled bet (130) returned to kinnho007
kinnho007 collected 260 from pot
kinnho007: doesn't show hand 
*** SUMMARY ***
Total pot 260 | Rake 0 
Board [4c 8s 9s 3c 8c]
Seat 1: FeGodines (button) folded before Flop (didn't bet)
Seat 2: flagao (small blind) folded before Flop
Seat 3: SBocha (big blind) folded on the River
Seat 4: Caduzzaum folded before Flop (didn't bet)
Seat 5: giovannifut folded before Flop (didn't bet)
Seat 6: fecomunale folded before Flop (didn't bet)
Seat 7: kinnho007 collected (260)
Seat 8: GreenMohawk88 folded before Flop (didn't bet)
Seat 9: h_liminha folded before Flop (didn't bet)



PokerStars Home Game Hand #211086496457: {Club #3217684} Tournament #2845705715, 17000+3000 Hold'em No Limit - Level II (20/40) - 2020/03/31 20:41:34 ET
Table '2845705715 1' 9-max Seat #2 is the button
Seat 1: FeGodines (10090 in chips) 
Seat 2: flagao (8825 in chips) 
Seat 3: SBocha (9460 in chips) 
Seat 4: Caduzzaum (11560 in chips) 
Seat 5: giovannifut (9925 in chips) 
Seat 6: fecomunale (8245 in chips) 
Seat 7: kinnho007 (11985 in chips) 
Seat 8: GreenMohawk88 (9955 in chips) is sitting out
Seat 9: h_liminha (9955 in chips) 
SBocha: posts small blind 20
Caduzzaum: posts big blind 40
*** HOLE CARDS ***
Dealt to flagao [2c Qs]
giovannifut: raises 80 to 120
fecomunale: folds 
kinnho007: folds 
GreenMohawk88: folds 
h_liminha: calls 120
FeGodines: calls 120
flagao: folds 
SBocha: calls 100
Caduzzaum: folds 
*** FLOP *** [8h Jd 4c]
SBocha: checks 
giovannifut: bets 400
h_liminha: calls 400
FeGodines: folds 
SBocha: calls 400
*** TURN *** [8h Jd 4c] [4d]
SBocha: checks 
giovannifut: checks 
h_liminha: bets 400
SBocha: calls 400
giovannifut: folds 
*** RIVER *** [8h Jd 4c 4d] [9d]
SBocha: checks 
h_liminha: bets 200
SBocha: calls 200
*** SHOW DOWN ***
h_liminha: shows [9h Jc] (two pair, Jacks and Nines)
SBocha: mucks hand 
h_liminha collected 2920 from pot
*** SUMMARY ***
Total pot 2920 | Rake 0 
Board [8h Jd 4c 4d 9d]
Seat 1: FeGodines folded on the Flop
Seat 2: flagao (button) folded before Flop (didn't bet)
Seat 3: SBocha (small blind) mucked [Qh Js]
Seat 4: Caduzzaum (big blind) folded before Flop
Seat 5: giovannifut folded on the Turn
Seat 6: fecomunale folded before Flop (didn't bet)
Seat 7: kinnho007 folded before Flop (didn't bet)
Seat 8: GreenMohawk88 folded before Flop (didn't bet)
Seat 9: h_liminha showed [9h Jc] and won (2920) with two pair, Jacks and Nines



PokerStars Home Game Hand #211086559163: {Club #3217684} Tournament #2845705715, 17000+3000 Hold'em No Limit - Level II (20/40) - 2020/03/31 20:43:12 ET
Table '2845705715 1' 9-max Seat #3 is the button
Seat 1: FeGodines (9970 in chips) 
Seat 2: flagao (8825 in chips) 
Seat 3: SBocha (8340 in chips) 
Seat 4: Caduzzaum (11520 in chips) 
Seat 5: giovannifut (9405 in chips) 
Seat 6: fecomunale (8245 in chips) 
Seat 7: kinnho007 (11985 in chips) 
Seat 8: GreenMohawk88 (9955 in chips) is sitting out
Seat 9: h_liminha (11755 in chips) 
Caduzzaum: posts small blind 20
giovannifut: posts big blind 40
*** HOLE CARDS ***
Dealt to flagao [4h 9d]
fecomunale: calls 40
kinnho007: folds 
GreenMohawk88: folds 
h_liminha: folds 
FeGodines: folds 
flagao: folds 
SBocha: calls 40
Caduzzaum: folds 
giovannifut: checks 
*** FLOP *** [5s Ts 9s]
giovannifut: bets 70
fecomunale: folds 
SBocha: calls 70
*** TURN *** [5s Ts 9s] [3h]
giovannifut: bets 140
SBocha: calls 140
*** RIVER *** [5s Ts 9s 3h] [5d]
giovannifut: checks 
SBocha: bets 280
giovannifut: folds [As]
Uncalled bet (280) returned to SBocha
SBocha collected 560 from pot
SBocha: doesn't show hand 
*** SUMMARY ***
Total pot 560 | Rake 0 
Board [5s Ts 9s 3h 5d]
Seat 1: FeGodines folded before Flop (didn't bet)
Seat 2: flagao folded before Flop (didn't bet)
Seat 3: SBocha (button) collected (560)
Seat 4: Caduzzaum (small blind) folded before Flop
Seat 5: giovannifut (big blind) folded on the River
Seat 6: fecomunale folded on the Flop
Seat 7: kinnho007 folded before Flop (didn't bet)
Seat 8: GreenMohawk88 folded before Flop (didn't bet)
Seat 9: h_liminha folded before Flop (didn't bet)



PokerStars Home Game Hand #211086615814: {Club #3217684} Tournament #2845705715, 17000+3000 Hold'em No Limit - Level II (20/40) - 2020/03/31 20:44:28 ET
Table '2845705715 1' 9-max Seat #4 is the button
Seat 1: FeGodines (9970 in chips) 
Seat 2: flagao (8825 in chips) 
Seat 3: SBocha (8650 in chips) 
Seat 4: Caduzzaum (11500 in chips) 
Seat 5: giovannifut (9155 in chips) 
Seat 6: fecomunale (8205 in chips) 
Seat 7: kinnho007 (11985 in chips) 
Seat 8: GreenMohawk88 (9955 in chips) 
Seat 9: h_liminha (11755 in chips) 
giovannifut: posts small blind 20
fecomunale: posts big blind 40
*** HOLE CARDS ***
Dealt to flagao [Ad Js]
kinnho007: folds 
GreenMohawk88: folds 
h_liminha: folds 
FeGodines: raises 80 to 120
flagao: calls 120
GreenMohawk88 said, "salveee"
SBocha: folds 
Caduzzaum: folds 
giovannifut: folds 
fecomunale: folds 
*** FLOP *** [Td 8s 8h]
FeGodines: bets 96
flagao: calls 96
*** TURN *** [Td 8s 8h] [6d]
FeGodines: bets 157
flagao: folds 
Uncalled bet (157) returned to FeGodines
FeGodines collected 492 from pot
FeGodines: doesn't show hand 
*** SUMMARY ***
Total pot 492 | Rake 0 
Board [Td 8s 8h 6d]
Seat 1: FeGodines collected (492)
Seat 2: flagao folded on the Turn
Seat 3: SBocha folded before Flop (didn't bet)
Seat 4: Caduzzaum (button) folded before Flop (didn't bet)
Seat 5: giovannifut (small blind) folded before Flop
Seat 6: fecomunale (big blind) folded before Flop
Seat 7: kinnho007 folded before Flop (didn't bet)
Seat 8: GreenMohawk88 folded before Flop (didn't bet)
Seat 9: h_liminha folded before Flop (didn't bet)



PokerStars Home Game Hand #211086651476: {Club #3217684} Tournament #2845705715, 17000+3000 Hold'em No Limit - Level II (20/40) - 2020/03/31 20:45:24 ET
Table '2845705715 1' 9-max Seat #5 is the button
Seat 1: FeGodines (10246 in chips) 
Seat 2: flagao (8609 in chips) 
Seat 3: SBocha (8650 in chips) 
Seat 4: Caduzzaum (11500 in chips) 
Seat 5: giovannifut (9135 in chips) 
Seat 6: fecomunale (8165 in chips) 
Seat 7: kinnho007 (11985 in chips) 
Seat 8: GreenMohawk88 (9955 in chips) 
Seat 9: h_liminha (11755 in chips) 
fecomunale: posts small blind 20
kinnho007: posts big blind 40
*** HOLE CARDS ***
Dealt to flagao [5d 9c]
GreenMohawk88 has timed out
GreenMohawk88: folds 
h_liminha: folds 
FeGodines: folds 
flagao: folds 
SBocha: folds 
Caduzzaum: raises 40 to 80
giovannifut: calls 80
fecomunale: calls 60
kinnho007: raises 320 to 400
Caduzzaum: folds 
giovannifut: folds 
fecomunale: folds 
Uncalled bet (320) returned to kinnho007
kinnho007 collected 320 from pot
kinnho007: doesn't show hand 
*** SUMMARY ***
Total pot 320 | Rake 0 
Seat 1: FeGodines folded before Flop (didn't bet)
Seat 2: flagao folded before Flop (didn't bet)
Seat 3: SBocha folded before Flop (didn't bet)
Seat 4: Caduzzaum folded before Flop
Seat 5: giovannifut (button) folded before Flop
Seat 6: fecomunale (small blind) folded before Flop
Seat 7: kinnho007 (big blind) collected (320)
Seat 8: GreenMohawk88 folded before Flop (didn't bet)
Seat 9: h_liminha folded before Flop (didn't bet)



PokerStars Home Game Hand #211086714146: {Club #3217684} Tournament #2845705715, 17000+3000 Hold'em No Limit - Level II (20/40) - 2020/03/31 20:47:04 ET
Table '2845705715 1' 9-max Seat #6 is the button
Seat 1: FeGodines (10246 in chips) 
Seat 2: flagao (8609 in chips) 
Seat 3: SBocha (8650 in chips) 
Seat 4: Caduzzaum (11420 in chips) 
Seat 5: giovannifut (9055 in chips) 
Seat 6: fecomunale (8085 in chips) 
Seat 7: kinnho007 (12225 in chips) 
Seat 8: GreenMohawk88 (9955 in chips) 
Seat 9: h_liminha (11755 in chips) 
kinnho007: posts small blind 20
GreenMohawk88: posts big blind 40
*** HOLE CARDS ***
Dealt to flagao [Jh 5d]
h_liminha: calls 40
FeGodines: folds 
flagao: folds 
SBocha: calls 40
Caduzzaum: folds 
giovannifut: calls 40
fecomunale: folds 
kinnho007: calls 20
GreenMohawk88: checks 
*** FLOP *** [9c 6h 8d]
kinnho007: checks 
GreenMohawk88: checks 
h_liminha: bets 80
SBocha: calls 80
giovannifut: calls 80
kinnho007: calls 80
GreenMohawk88: folds 
*** TURN *** [9c 6h 8d] [5c]
kinnho007: checks 
h_liminha: checks 
SBocha: bets 320
giovannifut: folds 
kinnho007: folds 
h_liminha: folds 
Uncalled bet (320) returned to SBocha
SBocha collected 520 from pot
SBocha: doesn't show hand 
*** SUMMARY ***
Total pot 520 | Rake 0 
Board [9c 6h 8d 5c]
Seat 1: FeGodines folded before Flop (didn't bet)
Seat 2: flagao folded before Flop (didn't bet)
Seat 3: SBocha collected (520)
Seat 4: Caduzzaum folded before Flop (didn't bet)
Seat 5: giovannifut folded on the Turn
Seat 6: fecomunale (button) folded before Flop (didn't bet)
Seat 7: kinnho007 (small blind) folded on the Turn
Seat 8: GreenMohawk88 (big blind) folded on the Flop
Seat 9: h_liminha folded on the Turn



PokerStars Home Game Hand #211086784192: {Club #3217684} Tournament #2845705715, 17000+3000 Hold'em No Limit - Level II (20/40) - 2020/03/31 20:48:55 ET
Table '2845705715 1' 9-max Seat #7 is the button
Seat 1: FeGodines (10246 in chips) 
Seat 2: flagao (8609 in chips) 
Seat 3: SBocha (9050 in chips) 
Seat 4: Caduzzaum (11420 in chips) 
Seat 5: giovannifut (8935 in chips) 
Seat 6: fecomunale (8085 in chips) 
Seat 7: kinnho007 (12105 in chips) 
Seat 8: GreenMohawk88 (9915 in chips) 
Seat 9: h_liminha (11635 in chips) 
GreenMohawk88: posts small blind 20
h_liminha: posts big blind 40
*** HOLE CARDS ***
Dealt to flagao [2d Td]
FeGodines: raises 80 to 120
flagao: folds 
SBocha: folds 
Caduzzaum: folds 
giovannifut: folds 
fecomunale: raises 80 to 200
kinnho007: folds 
GreenMohawk88: calls 180
h_liminha: folds 
FeGodines: calls 80
*** FLOP *** [Js 7c 3s]
GreenMohawk88: checks 
FeGodines: checks 
fecomunale: bets 320
GreenMohawk88: folds 
FeGodines: folds 
Uncalled bet (320) returned to fecomunale
fecomunale collected 640 from pot
GreenMohawk88 said, "ta osso"
fecomunale: doesn't show hand 
*** SUMMARY ***
Total pot 640 | Rake 0 
Board [Js 7c 3s]
Seat 1: FeGodines folded on the Flop
Seat 2: flagao folded before Flop (didn't bet)
Seat 3: SBocha folded before Flop (didn't bet)
Seat 4: Caduzzaum folded before Flop (didn't bet)
Seat 5: giovannifut folded before Flop (didn't bet)
Seat 6: fecomunale collected (640)
Seat 7: kinnho007 (button) folded before Flop (didn't bet)
Seat 8: GreenMohawk88 (small blind) folded on the Flop
Seat 9: h_liminha (big blind) folded before Flop



PokerStars Home Game Hand #211086820657: {Club #3217684} Tournament #2845705715, 17000+3000 Hold'em No Limit - Level II (20/40) - 2020/03/31 20:49:52 ET
Table '2845705715 1' 9-max Seat #8 is the button
Seat 1: FeGodines (10046 in chips) 
Seat 2: flagao (8609 in chips) 
Seat 3: SBocha (9050 in chips) 
Seat 4: Caduzzaum (11420 in chips) 
Seat 5: giovannifut (8935 in chips) 
Seat 6: fecomunale (8525 in chips) 
Seat 7: kinnho007 (12105 in chips) 
Seat 8: GreenMohawk88 (9715 in chips) 
Seat 9: h_liminha (11595 in chips) 
h_liminha: posts small blind 20
FeGodines: posts big blind 40
*** HOLE CARDS ***
Dealt to flagao [9h 3s]
flagao: folds 
SBocha: calls 40
Caduzzaum: folds 
giovannifut: folds 
fecomunale: folds 
kinnho007: calls 40
GreenMohawk88: raises 80 to 120
h_liminha: folds 
FeGodines: folds 
SBocha: calls 80
kinnho007: calls 80
*** FLOP *** [8s Tc 2h]
SBocha: checks 
kinnho007: checks 
GreenMohawk88: bets 160
SBocha: calls 160
kinnho007: folds 
*** TURN *** [8s Tc 2h] [Kd]
SBocha: checks 
GreenMohawk88: bets 200
SBocha: folds 
Uncalled bet (200) returned to GreenMohawk88
GreenMohawk88 collected 740 from pot
GreenMohawk88: doesn't show hand 
*** SUMMARY ***
Total pot 740 | Rake 0 
Board [8s Tc 2h Kd]
Seat 1: FeGodines (big blind) folded before Flop
Seat 2: flagao folded before Flop (didn't bet)
Seat 3: SBocha folded on the Turn
Seat 4: Caduzzaum folded before Flop (didn't bet)
Seat 5: giovannifut folded before Flop (didn't bet)
Seat 6: fecomunale folded before Flop (didn't bet)
Seat 7: kinnho007 folded on the Flop
Seat 8: GreenMohawk88 (button) collected (740)
Seat 9: h_liminha (small blind) folded before Flop



PokerStars Home Game Hand #211086867690: {Club #3217684} Tournament #2845705715, 17000+3000 Hold'em No Limit - Level III (25/50) - 2020/03/31 20:51:07 ET
Table '2845705715 1' 9-max Seat #9 is the button
Seat 1: FeGodines (10006 in chips) 
Seat 2: flagao (8609 in chips) 
Seat 3: SBocha (8770 in chips) 
Seat 4: Caduzzaum (11420 in chips) 
Seat 5: giovannifut (8935 in chips) 
Seat 6: fecomunale (8525 in chips) 
Seat 7: kinnho007 (11985 in chips) 
Seat 8: GreenMohawk88 (10175 in chips) 
Seat 9: h_liminha (11575 in chips) 
FeGodines: posts small blind 25
flagao: posts big blind 50
*** HOLE CARDS ***
Dealt to flagao [6c 4h]
SBocha: calls 50
Caduzzaum: raises 50 to 100
giovannifut: folds 
fecomunale: folds 
kinnho007: folds 
GreenMohawk88: calls 100
h_liminha: folds 
FeGodines: folds 
flagao: folds 
SBocha: folds 
*** FLOP *** [7d 8h 6s]
Caduzzaum: checks 
GreenMohawk88: bets 200
Caduzzaum: folds 
Uncalled bet (200) returned to GreenMohawk88
GreenMohawk88 collected 325 from pot
GreenMohawk88: doesn't show hand 
*** SUMMARY ***
Total pot 325 | Rake 0 
Board [7d 8h 6s]
Seat 1: FeGodines (small blind) folded before Flop
Seat 2: flagao (big blind) folded before Flop
Seat 3: SBocha folded before Flop
Seat 4: Caduzzaum folded on the Flop
Seat 5: giovannifut folded before Flop (didn't bet)
Seat 6: fecomunale folded before Flop (didn't bet)
Seat 7: kinnho007 folded before Flop (didn't bet)
Seat 8: GreenMohawk88 collected (325)
Seat 9: h_liminha (button) folded before Flop (didn't bet)



PokerStars Home Game Hand #211086908805: {Club #3217684} Tournament #2845705715, 17000+3000 Hold'em No Limit - Level III (25/50) - 2020/03/31 20:52:10 ET
Table '2845705715 1' 9-max Seat #1 is the button
Seat 1: FeGodines (9981 in chips) 
Seat 2: flagao (8559 in chips) 
Seat 3: SBocha (8720 in chips) 
Seat 4: Caduzzaum (11320 in chips) 
Seat 5: giovannifut (8935 in chips) 
Seat 6: fecomunale (8525 in chips) 
Seat 7: kinnho007 (11985 in chips) 
Seat 8: GreenMohawk88 (10400 in chips) 
Seat 9: h_liminha (11575 in chips) 
flagao: posts small blind 25
SBocha: posts big blind 50
*** HOLE CARDS ***
Dealt to flagao [9d Kh]
Caduzzaum: folds 
giovannifut: folds 
fecomunale: folds 
kinnho007: folds 
GreenMohawk88: calls 50
h_liminha: folds 
FeGodines: calls 50
flagao: calls 25
SBocha: checks 
*** FLOP *** [3d 5d 4s]
flagao: checks 
SBocha: bets 50
GreenMohawk88: calls 50
FeGodines: folds 
flagao: folds 
*** TURN *** [3d 5d 4s] [3h]
SBocha: bets 50
GreenMohawk88: calls 50
*** RIVER *** [3d 5d 4s 3h] [5h]
SBocha: bets 50
GreenMohawk88: calls 50
*** SHOW DOWN ***
SBocha: shows [Ah 4c] (two pair, Fives and Fours)
GreenMohawk88: mucks hand 
SBocha collected 500 from pot
*** SUMMARY ***
Total pot 500 | Rake 0 
Board [3d 5d 4s 3h 5h]
Seat 1: FeGodines (button) folded on the Flop
Seat 2: flagao (small blind) folded on the Flop
Seat 3: SBocha (big blind) showed [Ah 4c] and won (500) with two pair, Fives and Fours
Seat 4: Caduzzaum folded before Flop (didn't bet)
Seat 5: giovannifut folded before Flop (didn't bet)
Seat 6: fecomunale folded before Flop (didn't bet)
Seat 7: kinnho007 folded before Flop (didn't bet)
Seat 8: GreenMohawk88 mucked [Jd 4h]
Seat 9: h_liminha folded before Flop (didn't bet)



PokerStars Home Game Hand #211086952512: {Club #3217684} Tournament #2845705715, 17000+3000 Hold'em No Limit - Level III (25/50) - 2020/03/31 20:53:04 ET
Table '2845705715 1' 9-max Seat #2 is the button
Seat 1: FeGodines (9931 in chips) 
Seat 2: flagao (8509 in chips) 
Seat 3: SBocha (9020 in chips) 
Seat 4: Caduzzaum (11320 in chips) 
Seat 5: giovannifut (8935 in chips) 
Seat 6: fecomunale (8525 in chips) 
Seat 7: kinnho007 (11985 in chips) 
Seat 8: GreenMohawk88 (10200 in chips) 
Seat 9: h_liminha (11575 in chips) 
SBocha: posts small blind 25
Caduzzaum: posts big blind 50
*** HOLE CARDS ***
Dealt to flagao [Jd 7d]
GreenMohawk88 said, "tambem tinha o 4"
GreenMohawk88 said, "hahaha"
giovannifut: folds 
fecomunale: folds 
kinnho007: raises 50 to 100
GreenMohawk88 said, "perdi no kicker"
GreenMohawk88: folds 
h_liminha: calls 100
FeGodines: raises 300 to 400
flagao: folds 
SBocha: folds 
Caduzzaum: folds 
kinnho007: calls 300
h_liminha: calls 300
*** FLOP *** [2h 2c 3h]
kinnho007: bets 638
h_liminha: folds 
FeGodines: calls 638
*** TURN *** [2h 2c 3h] [8c]
kinnho007: checks 
FeGodines: checks 
*** RIVER *** [2h 2c 3h 8c] [Th]
kinnho007: bets 1276
FeGodines: folds 
Uncalled bet (1276) returned to kinnho007
kinnho007 collected 2551 from pot
kinnho007: doesn't show hand 
*** SUMMARY ***
Total pot 2551 | Rake 0 
Board [2h 2c 3h 8c Th]
Seat 1: FeGodines folded on the River
Seat 2: flagao (button) folded before Flop (didn't bet)
Seat 3: SBocha (small blind) folded before Flop
Seat 4: Caduzzaum (big blind) folded before Flop
Seat 5: giovannifut folded before Flop (didn't bet)
Seat 6: fecomunale folded before Flop (didn't bet)
Seat 7: kinnho007 collected (2551)
Seat 8: GreenMohawk88 folded before Flop (didn't bet)
Seat 9: h_liminha folded on the Flop



PokerStars Home Game Hand #211087012591: {Club #3217684} Tournament #2845705715, 17000+3000 Hold'em No Limit - Level III (25/50) - 2020/03/31 20:54:37 ET
Table '2845705715 1' 9-max Seat #3 is the button
Seat 1: FeGodines (8893 in chips) 
Seat 2: flagao (8509 in chips) 
Seat 3: SBocha (8995 in chips) 
Seat 4: Caduzzaum (11270 in chips) 
Seat 5: giovannifut (8935 in chips) 
Seat 6: fecomunale (8525 in chips) 
Seat 7: kinnho007 (13498 in chips) 
Seat 8: GreenMohawk88 (10200 in chips) 
Seat 9: h_liminha (11175 in chips) 
Caduzzaum: posts small blind 25
giovannifut: posts big blind 50
*** HOLE CARDS ***
Dealt to flagao [Ac Ks]
fecomunale: folds 
kinnho007: calls 50
GreenMohawk88: raises 50 to 100
h_liminha: folds 
FeGodines: folds 
flagao: raises 150 to 250
SBocha: folds 
Caduzzaum: folds 
giovannifut: folds 
kinnho007: calls 200
GreenMohawk88: calls 150
*** FLOP *** [6c 3h 7d]
GreenMohawk88 said, "kkkkk"
kinnho007: bets 413
GreenMohawk88: folds 
flagao: folds 
Uncalled bet (413) returned to kinnho007
kinnho007 collected 825 from pot
kinnho007: doesn't show hand 
*** SUMMARY ***
Total pot 825 | Rake 0 
Board [6c 3h 7d]
Seat 1: FeGodines folded before Flop (didn't bet)
Seat 2: flagao folded on the Flop
Seat 3: SBocha (button) folded before Flop (didn't bet)
Seat 4: Caduzzaum (small blind) folded before Flop
Seat 5: giovannifut (big blind) folded before Flop
Seat 6: fecomunale folded before Flop (didn't bet)
Seat 7: kinnho007 collected (825)
Seat 8: GreenMohawk88 folded on the Flop
Seat 9: h_liminha folded before Flop (didn't bet)



PokerStars Home Game Hand #211087229862: {Club #3217684} Tournament #2845705715, 17000+3000 Hold'em No Limit - Level III (25/50) - 2020/03/31 21:01:17 ET
Table '2845705715 1' 9-max Seat #4 is the button
Seat 1: FeGodines (8893 in chips) 
Seat 2: flagao (8259 in chips) 
Seat 3: SBocha (8995 in chips) 
Seat 4: Caduzzaum (11245 in chips) 
Seat 5: giovannifut (8885 in chips) 
Seat 6: fecomunale (8525 in chips) 
Seat 7: kinnho007 (14073 in chips) 
Seat 8: GreenMohawk88 (9950 in chips) 
Seat 9: h_liminha (11175 in chips) 
giovannifut: posts small blind 25
fecomunale: posts big blind 50
*** HOLE CARDS ***
Dealt to flagao [Jd Ts]
kinnho007: calls 50
GreenMohawk88: calls 50
h_liminha: calls 50
FeGodines: folds 
flagao: folds 
SBocha: calls 50
Caduzzaum: folds 
giovannifut: calls 25
fecomunale: checks 
*** FLOP *** [5d 7c 9c]
giovannifut: checks 
fecomunale: checks 
kinnho007: checks 
GreenMohawk88: bets 100
h_liminha: calls 100
SBocha: folds 
giovannifut: calls 100
fecomunale: folds 
kinnho007: calls 100
*** TURN *** [5d 7c 9c] [3h]
giovannifut: bets 350
kinnho007: folds 
GreenMohawk88: calls 350
h_liminha: calls 350
*** RIVER *** [5d 7c 9c 3h] [3c]
giovannifut: checks 
GreenMohawk88: checks 
h_liminha: bets 500
giovannifut: calls 500
GreenMohawk88: folds 
*** SHOW DOWN ***
h_liminha: shows [9h Th] (two pair, Nines and Threes)
giovannifut: mucks hand 
h_liminha collected 2750 from pot
*** SUMMARY ***
Total pot 2750 | Rake 0 
Board [5d 7c 9c 3h 3c]
Seat 1: FeGodines folded before Flop (didn't bet)
Seat 2: flagao folded before Flop (didn't bet)
Seat 3: SBocha folded on the Flop
Seat 4: Caduzzaum (button) folded before Flop (didn't bet)
Seat 5: giovannifut (small blind) mucked [9s 2h]
Seat 6: fecomunale (big blind) folded on the Flop
Seat 7: kinnho007 folded on the Turn
Seat 8: GreenMohawk88 folded on the River
Seat 9: h_liminha showed [9h Th] and won (2750) with two pair, Nines and Threes



PokerStars Home Game Hand #211087291071: {Club #3217684} Tournament #2845705715, 17000+3000 Hold'em No Limit - Level III (25/50) - 2020/03/31 21:02:57 ET
Table '2845705715 1' 9-max Seat #5 is the button
Seat 1: FeGodines (8893 in chips) 
Seat 2: flagao (8259 in chips) 
Seat 3: SBocha (8945 in chips) 
Seat 4: Caduzzaum (11245 in chips) 
Seat 5: giovannifut (7885 in chips) 
Seat 6: fecomunale (8475 in chips) 
Seat 7: kinnho007 (13923 in chips) 
Seat 8: GreenMohawk88 (9450 in chips) 
Seat 9: h_liminha (12925 in chips) 
fecomunale: posts small blind 25
kinnho007: posts big blind 50
*** HOLE CARDS ***
Dealt to flagao [9d 2s]
GreenMohawk88: folds 
h_liminha: folds 
FeGodines: calls 50
flagao: folds 
SBocha: folds 
Caduzzaum: folds 
giovannifut: folds 
fecomunale: calls 25
kinnho007: checks 
*** FLOP *** [7d 4h 6h]
fecomunale: checks 
kinnho007: bets 150
FeGodines: calls 150
fecomunale: folds 
*** TURN *** [7d 4h 6h] [Jc]
kinnho007: bets 225
FeGodines: calls 225
*** RIVER *** [7d 4h 6h Jc] [Js]
kinnho007: bets 450
FeGodines: calls 450
*** SHOW DOWN ***
kinnho007: shows [9h Kc] (a pair of Jacks)
FeGodines: shows [6d 7c] (two pair, Jacks and Sevens)
FeGodines collected 1800 from pot
*** SUMMARY ***
Total pot 1800 | Rake 0 
Board [7d 4h 6h Jc Js]
Seat 1: FeGodines showed [6d 7c] and won (1800) with two pair, Jacks and Sevens
Seat 2: flagao folded before Flop (didn't bet)
Seat 3: SBocha folded before Flop (didn't bet)
Seat 4: Caduzzaum folded before Flop (didn't bet)
Seat 5: giovannifut (button) folded before Flop (didn't bet)
Seat 6: fecomunale (small blind) folded on the Flop
Seat 7: kinnho007 (big blind) showed [9h Kc] and lost with a pair of Jacks
Seat 8: GreenMohawk88 folded before Flop (didn't bet)
Seat 9: h_liminha folded before Flop (didn't bet)



PokerStars Home Game Hand #211087368753: {Club #3217684} Tournament #2845705715, 17000+3000 Hold'em No Limit - Level III (25/50) - 2020/03/31 21:05:03 ET
Table '2845705715 1' 9-max Seat #6 is the button
Seat 1: FeGodines (9818 in chips) 
Seat 2: flagao (8259 in chips) 
Seat 3: SBocha (8945 in chips) 
Seat 4: Caduzzaum (11245 in chips) 
Seat 5: giovannifut (7885 in chips) 
Seat 6: fecomunale (8425 in chips) 
Seat 7: kinnho007 (13048 in chips) 
Seat 8: GreenMohawk88 (9450 in chips) 
Seat 9: h_liminha (12925 in chips) 
kinnho007: posts small blind 25
GreenMohawk88: posts big blind 50
*** HOLE CARDS ***
Dealt to flagao [Ah 4c]
FeGodines said, "kinho"
FeGodines said, "ME RESPEITA"
h_liminha: folds 
FeGodines: calls 50
flagao: folds 
GreenMohawk88 said, "hahahaha"
SBocha: calls 50
Caduzzaum: calls 50
giovannifut: folds 
fecomunale: folds 
kinnho007: folds 
GreenMohawk88: checks 
*** FLOP *** [8c 3h Td]
GreenMohawk88: checks 
FeGodines: bets 119
kinnho007 said, "kkk"
SBocha: calls 119
kinnho007 said, "parei"
Caduzzaum: raises 582 to 701
GreenMohawk88: folds 
FeGodines: folds 
SBocha: calls 582
*** TURN *** [8c 3h Td] [9c]
SBocha: bets 1746
kinnho007 said, "FlagÃ£o ,troquei ideia comigo e nÃ£o funcionou kkkkk"
Caduzzaum: raises 1746 to 3492
SBocha: raises 4696 to 8188
flagao said, "HAHAHAHAHA"
Caduzzaum: folds 
Uncalled bet (4696) returned to SBocha
SBocha collected 8730 from pot
SBocha: doesn't show hand 
*** SUMMARY ***
Total pot 8730 | Rake 0 
Board [8c 3h Td 9c]
Seat 1: FeGodines folded on the Flop
Seat 2: flagao folded before Flop (didn't bet)
Seat 3: SBocha collected (8730)
Seat 4: Caduzzaum folded on the Turn
Seat 5: giovannifut folded before Flop (didn't bet)
Seat 6: fecomunale (button) folded before Flop (didn't bet)
Seat 7: kinnho007 (small blind) folded before Flop
Seat 8: GreenMohawk88 (big blind) folded on the Flop
Seat 9: h_liminha folded before Flop (didn't bet)



PokerStars Home Game Hand #211087449625: {Club #3217684} Tournament #2845705715, 17000+3000 Hold'em No Limit - Level IV (30/60) - 2020/03/31 21:07:00 ET
Table '2845705715 1' 9-max Seat #7 is the button
Seat 1: FeGodines (9649 in chips) 
Seat 2: flagao (8259 in chips) 
Seat 3: SBocha (13432 in chips) 
Seat 4: Caduzzaum (7002 in chips) 
Seat 5: giovannifut (7885 in chips) 
Seat 6: fecomunale (8425 in chips) 
Seat 7: kinnho007 (13023 in chips) 
Seat 8: GreenMohawk88 (9400 in chips) 
Seat 9: h_liminha (12925 in chips) 
FeGodines: posts the ante 5
flagao: posts the ante 5
SBocha: posts the ante 5
Caduzzaum: posts the ante 5
giovannifut: posts the ante 5
fecomunale: posts the ante 5
kinnho007: posts the ante 5
GreenMohawk88: posts the ante 5
h_liminha: posts the ante 5
GreenMohawk88: posts small blind 30
h_liminha: posts big blind 60
*** HOLE CARDS ***
Dealt to flagao [Th Ts]
FeGodines: folds 
flagao: raises 120 to 180
SBocha: calls 180
Caduzzaum: folds 
giovannifut: folds 
fecomunale: calls 180
kinnho007: folds 
GreenMohawk88: calls 150
h_liminha: calls 120
*** FLOP *** [4d 4s 6s]
GreenMohawk88: checks 
h_liminha: checks 
flagao: bets 240
SBocha: calls 240
fecomunale: calls 240
GreenMohawk88: calls 240
h_liminha: folds 
*** TURN *** [4d 4s 6s] [8c]
GreenMohawk88: checks 
flagao: checks 
SBocha: checks 
fecomunale: checks 
*** RIVER *** [4d 4s 6s 8c] [Ac]
GreenMohawk88: checks 
flagao: checks 
SBocha: checks 
fecomunale: checks 
*** SHOW DOWN ***
GreenMohawk88: shows [6h 3s] (two pair, Sixes and Fours)
flagao: shows [Th Ts] (two pair, Tens and Fours)
SBocha: shows [Qd Ad] (two pair, Aces and Fours)
fecomunale: mucks hand 
SBocha collected 1905 from pot
*** SUMMARY ***
Total pot 1905 | Rake 0 
Board [4d 4s 6s 8c Ac]
Seat 1: FeGodines folded before Flop (didn't bet)
Seat 2: flagao showed [Th Ts] and lost with two pair, Tens and Fours
Seat 3: SBocha showed [Qd Ad] and won (1905) with two pair, Aces and Fours
Seat 4: Caduzzaum folded before Flop (didn't bet)
Seat 5: giovannifut folded before Flop (didn't bet)
Seat 6: fecomunale mucked [Jh Kd]
Seat 7: kinnho007 (button) folded before Flop (didn't bet)
Seat 8: GreenMohawk88 (small blind) showed [6h 3s] and lost with two pair, Sixes and Fours
Seat 9: h_liminha (big blind) folded on the Flop



PokerStars Home Game Hand #211087491232: {Club #3217684} Tournament #2845705715, 17000+3000 Hold'em No Limit - Level IV (30/60) - 2020/03/31 21:08:07 ET
Table '2845705715 1' 9-max Seat #8 is the button
Seat 1: FeGodines (9644 in chips) 
Seat 2: flagao (7834 in chips) 
Seat 3: SBocha (14912 in chips) 
Seat 4: Caduzzaum (6997 in chips) 
Seat 5: giovannifut (7880 in chips) 
Seat 6: fecomunale (8000 in chips) 
Seat 7: kinnho007 (13018 in chips) 
Seat 8: GreenMohawk88 (8975 in chips) 
Seat 9: h_liminha (12740 in chips) 
FeGodines: posts the ante 5
flagao: posts the ante 5
SBocha: posts the ante 5
Caduzzaum: posts the ante 5
giovannifut: posts the ante 5
fecomunale: posts the ante 5
kinnho007: posts the ante 5
GreenMohawk88: posts the ante 5
h_liminha: posts the ante 5
h_liminha: posts small blind 30
FeGodines: posts big blind 60
*** HOLE CARDS ***
Dealt to flagao [Jd 8d]
flagao: folds 
SBocha: folds 
Caduzzaum: folds 
giovannifut: raises 120 to 180
fecomunale: folds 
kinnho007: folds 
GreenMohawk88: calls 180
h_liminha: calls 150
FeGodines said, "GIo cade vc no discord?"
FeGodines: folds 
*** FLOP *** [3h Ad 3s]
h_liminha: checks 
giovannifut: checks 
GreenMohawk88: checks 
*** TURN *** [3h Ad 3s] [Ac]
h_liminha: checks 
giovannifut: checks 
GreenMohawk88: bets 240
h_liminha: folds 
giovannifut: folds [2h 2d]
Uncalled bet (240) returned to GreenMohawk88
GreenMohawk88 collected 645 from pot
GreenMohawk88: doesn't show hand 
GreenMohawk88 said, "kkkk"
*** SUMMARY ***
Total pot 645 | Rake 0 
Board [3h Ad 3s Ac]
Seat 1: FeGodines (big blind) folded before Flop
Seat 2: flagao folded before Flop (didn't bet)
Seat 3: SBocha folded before Flop (didn't bet)
Seat 4: Caduzzaum folded before Flop (didn't bet)
Seat 5: giovannifut folded on the Turn
Seat 6: fecomunale folded before Flop (didn't bet)
Seat 7: kinnho007 folded before Flop (didn't bet)
Seat 8: GreenMohawk88 (button) collected (645)
Seat 9: h_liminha (small blind) folded on the Turn



PokerStars Home Game Hand #211087528322: {Club #3217684} Tournament #2845705715, 17000+3000 Hold'em No Limit - Level IV (30/60) - 2020/03/31 21:09:08 ET
Table '2845705715 1' 9-max Seat #9 is the button
Seat 1: FeGodines (9579 in chips) 
Seat 2: flagao (7829 in chips) 
Seat 3: SBocha (14907 in chips) 
Seat 4: Caduzzaum (6992 in chips) 
Seat 5: giovannifut (7695 in chips) 
Seat 6: fecomunale (7995 in chips) 
Seat 7: kinnho007 (13013 in chips) 
Seat 8: GreenMohawk88 (9435 in chips) 
Seat 9: h_liminha (12555 in chips) 
FeGodines: posts the ante 5
flagao: posts the ante 5
SBocha: posts the ante 5
Caduzzaum: posts the ante 5
giovannifut: posts the ante 5
fecomunale: posts the ante 5
kinnho007: posts the ante 5
GreenMohawk88: posts the ante 5
h_liminha: posts the ante 5
FeGodines: posts small blind 30
flagao: posts big blind 60
*** HOLE CARDS ***
Dealt to flagao [Ac 6c]
SBocha: folds 
Caduzzaum: folds 
giovannifut: calls 60
fecomunale: folds 
kinnho007: calls 60
GreenMohawk88: calls 60
h_liminha: folds 
FeGodines: folds 
flagao: raises 120 to 180
giovannifut: calls 120
kinnho007: calls 120
GreenMohawk88: calls 120
*** FLOP *** [9h 6h 8h]
flagao: bets 180
giovannifut: folds 
kinnho007: calls 180
GreenMohawk88 said, "sacanagem"
GreenMohawk88: calls 180
*** TURN *** [9h 6h 8h] [Ts]
flagao: checks 
kinnho007: checks 
GreenMohawk88: bets 300
flagao: folds 
kinnho007: calls 300
*** RIVER *** [9h 6h 8h Ts] [4c]
kinnho007: checks 
GreenMohawk88: bets 540
kinnho007: folds 
Uncalled bet (540) returned to GreenMohawk88
GreenMohawk88 collected 1935 from pot
GreenMohawk88: doesn't show hand 
*** SUMMARY ***
Total pot 1935 | Rake 0 
Board [9h 6h 8h Ts 4c]
Seat 1: FeGodines (small blind) folded before Flop
Seat 2: flagao (big blind) folded on the Turn
Seat 3: SBocha folded before Flop (didn't bet)
Seat 4: Caduzzaum folded before Flop (didn't bet)
Seat 5: giovannifut folded on the Flop
Seat 6: fecomunale folded before Flop (didn't bet)
Seat 7: kinnho007 folded on the River
Seat 8: GreenMohawk88 collected (1935)
Seat 9: h_liminha (button) folded before Flop (didn't bet)



PokerStars Home Game Hand #211087589640: {Club #3217684} Tournament #2845705715, 17000+3000 Hold'em No Limit - Level IV (30/60) - 2020/03/31 21:10:49 ET
Table '2845705715 1' 9-max Seat #1 is the button
Seat 1: FeGodines (9544 in chips) 
Seat 2: flagao (7464 in chips) 
Seat 3: SBocha (14902 in chips) 
Seat 4: Caduzzaum (6987 in chips) 
Seat 5: giovannifut (7510 in chips) 
Seat 6: fecomunale (7990 in chips) 
Seat 7: kinnho007 (12348 in chips) 
Seat 8: GreenMohawk88 (10705 in chips) 
Seat 9: h_liminha (12550 in chips) 
FeGodines: posts the ante 5
flagao: posts the ante 5
SBocha: posts the ante 5
Caduzzaum: posts the ante 5
giovannifut: posts the ante 5
fecomunale: posts the ante 5
kinnho007: posts the ante 5
GreenMohawk88: posts the ante 5
h_liminha: posts the ante 5
flagao: posts small blind 30
SBocha: posts big blind 60
*** HOLE CARDS ***
Dealt to flagao [2h Td]
Caduzzaum: folds 
giovannifut: folds 
fecomunale: folds 
kinnho007: folds 
GreenMohawk88: calls 60
h_liminha: calls 60
FeGodines: calls 60
flagao: folds 
SBocha: checks 
*** FLOP *** [Js 7h 6s]
SBocha: checks 
GreenMohawk88: checks 
h_liminha: checks 
FeGodines: bets 167
SBocha: calls 167
GreenMohawk88: folds 
h_liminha: calls 167
*** TURN *** [Js 7h 6s] [5d]
GreenMohawk88 said, "kkkkkk"
SBocha: checks 
h_liminha: checks 
FeGodines: bets 261
SBocha: folds 
h_liminha: calls 261
*** RIVER *** [Js 7h 6s 5d] [9c]
h_liminha: checks 
FeGodines: checks 
*** SHOW DOWN ***
h_liminha: shows [8h 7s] (a straight, Five to Nine)
FeGodines: mucks hand 
h_liminha collected 1338 from pot
GreenMohawk88 said, "muiÃ© ta vendo tv, se eu ligar aqui, vai atrapalhar ai"
*** SUMMARY ***
Total pot 1338 | Rake 0 
Board [Js 7h 6s 5d 9c]
Seat 1: FeGodines (button) mucked [Jc Kd]
Seat 2: flagao (small blind) folded before Flop
Seat 3: SBocha (big blind) folded on the Turn
Seat 4: Caduzzaum folded before Flop (didn't bet)
Seat 5: giovannifut folded before Flop (didn't bet)
Seat 6: fecomunale folded before Flop (didn't bet)
Seat 7: kinnho007 folded before Flop (didn't bet)
Seat 8: GreenMohawk88 folded on the Flop
Seat 9: h_liminha showed [8h 7s] and won (1338) with a straight, Five to Nine



PokerStars Home Game Hand #211087633714: {Club #3217684} Tournament #2845705715, 17000+3000 Hold'em No Limit - Level IV (30/60) - 2020/03/31 21:12:01 ET
Table '2845705715 1' 9-max Seat #2 is the button
Seat 1: FeGodines (9051 in chips) 
Seat 2: flagao (7429 in chips) 
Seat 3: SBocha (14670 in chips) 
Seat 4: Caduzzaum (6982 in chips) 
Seat 5: giovannifut (7505 in chips) 
Seat 6: fecomunale (7985 in chips) 
Seat 7: kinnho007 (12343 in chips) 
Seat 8: GreenMohawk88 (10640 in chips) 
Seat 9: h_liminha (13395 in chips) 
FeGodines: posts the ante 5
flagao: posts the ante 5
SBocha: posts the ante 5
Caduzzaum: posts the ante 5
giovannifut: posts the ante 5
fecomunale: posts the ante 5
kinnho007: posts the ante 5
GreenMohawk88: posts the ante 5
h_liminha: posts the ante 5
SBocha: posts small blind 30
Caduzzaum: posts big blind 60
*** HOLE CARDS ***
Dealt to flagao [Ts Qh]
giovannifut: folds 
fecomunale: folds 
kinnho007: folds 
GreenMohawk88: calls 60
h_liminha: calls 60
FeGodines: folds 
flagao: calls 60
SBocha: calls 30
Caduzzaum: checks 
*** FLOP *** [9s Qs 2s]
FeGodines said, "Lima safado"
SBocha: checks 
Caduzzaum: checks 
GreenMohawk88: checks 
h_liminha: checks 
h_liminha said, "kkkkkkkk"
flagao: bets 120
SBocha: calls 120
Caduzzaum: folds 
GreenMohawk88: calls 120
h_liminha: folds 
*** TURN *** [9s Qs 2s] [Ac]
SBocha: checks 
GreenMohawk88: bets 240
flagao: calls 240
SBocha: folds 
*** RIVER *** [9s Qs 2s Ac] [Kd]
GreenMohawk88: checks 
flagao: checks 
*** SHOW DOWN ***
GreenMohawk88: shows [2h As] (two pair, Aces and Deuces)
flagao: mucks hand 
GreenMohawk88 collected 1185 from pot
GreenMohawk88 said, "ahhhh"
*** SUMMARY ***
Total pot 1185 | Rake 0 
Board [9s Qs 2s Ac Kd]
Seat 1: FeGodines folded before Flop (didn't bet)
Seat 2: flagao (button) mucked [Ts Qh]
Seat 3: SBocha (small blind) folded on the Turn
Seat 4: Caduzzaum (big blind) folded on the Flop
Seat 5: giovannifut folded before Flop (didn't bet)
Seat 6: fecomunale folded before Flop (didn't bet)
Seat 7: kinnho007 folded before Flop (didn't bet)
Seat 8: GreenMohawk88 showed [2h As] and won (1185) with two pair, Aces and Deuces
Seat 9: h_liminha folded on the Flop



PokerStars Home Game Hand #211087685213: {Club #3217684} Tournament #2845705715, 17000+3000 Hold'em No Limit - Level IV (30/60) - 2020/03/31 21:13:28 ET
Table '2845705715 1' 9-max Seat #3 is the button
Seat 1: FeGodines (9046 in chips) 
Seat 2: flagao (7004 in chips) 
Seat 3: SBocha (14485 in chips) 
Seat 4: Caduzzaum (6917 in chips) 
Seat 5: giovannifut (7500 in chips) 
Seat 6: fecomunale (7980 in chips) 
Seat 7: kinnho007 (12338 in chips) 
Seat 8: GreenMohawk88 (11400 in chips) 
Seat 9: h_liminha (13330 in chips) 
FeGodines: posts the ante 5
flagao: posts the ante 5
SBocha: posts the ante 5
Caduzzaum: posts the ante 5
giovannifut: posts the ante 5
fecomunale: posts the ante 5
kinnho007: posts the ante 5
GreenMohawk88: posts the ante 5
h_liminha: posts the ante 5
Caduzzaum: posts small blind 30
giovannifut: posts big blind 60
*** HOLE CARDS ***
Dealt to flagao [5s 6c]
GreenMohawk88 said, "pensei que ia apostar"
flagao said, "Com A e K? tÃ´ fora"
fecomunale: folds 
kinnho007: calls 60
GreenMohawk88 said, "kkkk"
GreenMohawk88: folds 
h_liminha: folds 
FeGodines: folds 
flagao: folds 
SBocha: calls 60
Caduzzaum: calls 30
giovannifut: checks 
*** FLOP *** [4c 4h Ts]
Caduzzaum: checks 
giovannifut: checks 
kinnho007: checks 
SBocha: checks 
*** TURN *** [4c 4h Ts] [4s]
Caduzzaum: checks 
giovannifut: checks 
kinnho007: checks 
SBocha: checks 
*** RIVER *** [4c 4h Ts 4s] [3c]
Caduzzaum: checks 
giovannifut: bets 143
kinnho007: folds 
SBocha: folds 
Caduzzaum: folds 
Uncalled bet (143) returned to giovannifut
giovannifut collected 285 from pot
giovannifut: doesn't show hand 
*** SUMMARY ***
Total pot 285 | Rake 0 
Board [4c 4h Ts 4s 3c]
Seat 1: FeGodines folded before Flop (didn't bet)
Seat 2: flagao folded before Flop (didn't bet)
Seat 3: SBocha (button) folded on the River
Seat 4: Caduzzaum (small blind) folded on the River
Seat 5: giovannifut (big blind) collected (285)
Seat 6: fecomunale folded before Flop (didn't bet)
Seat 7: kinnho007 folded on the River
Seat 8: GreenMohawk88 folded before Flop (didn't bet)
Seat 9: h_liminha folded before Flop (didn't bet)



PokerStars Home Game Hand #211087748604: {Club #3217684} Tournament #2845705715, 17000+3000 Hold'em No Limit - Level IV (30/60) - 2020/03/31 21:14:57 ET
Table '2845705715 1' 9-max Seat #4 is the button
Seat 1: FeGodines (9041 in chips) 
Seat 2: flagao (6999 in chips) 
Seat 3: SBocha (14420 in chips) 
Seat 4: Caduzzaum (6852 in chips) 
Seat 5: giovannifut (7720 in chips) 
Seat 6: fecomunale (7975 in chips) 
Seat 7: kinnho007 (12273 in chips) 
Seat 8: GreenMohawk88 (11395 in chips) 
Seat 9: h_liminha (13325 in chips) 
FeGodines: posts the ante 5
flagao: posts the ante 5
SBocha: posts the ante 5
Caduzzaum: posts the ante 5
giovannifut: posts the ante 5
fecomunale: posts the ante 5
kinnho007: posts the ante 5
GreenMohawk88: posts the ante 5
h_liminha: posts the ante 5
giovannifut: posts small blind 30
fecomunale: posts big blind 60
*** HOLE CARDS ***
Dealt to flagao [As 6d]
kinnho007: folds 
GreenMohawk88: calls 60
h_liminha: calls 60
FeGodines: folds 
flagao: folds 
SBocha: folds 
Caduzzaum: calls 60
giovannifut: calls 30
fecomunale: checks 
*** FLOP *** [Kd 2c 7c]
giovannifut: checks 
fecomunale: bets 240
GreenMohawk88: folds 
h_liminha: folds 
Caduzzaum: folds 
giovannifut: folds 
Uncalled bet (240) returned to fecomunale
fecomunale collected 345 from pot
fecomunale: doesn't show hand 
*** SUMMARY ***
Total pot 345 | Rake 0 
Board [Kd 2c 7c]
Seat 1: FeGodines folded before Flop (didn't bet)
Seat 2: flagao folded before Flop (didn't bet)
Seat 3: SBocha folded before Flop (didn't bet)
Seat 4: Caduzzaum (button) folded on the Flop
Seat 5: giovannifut (small blind) folded on the Flop
Seat 6: fecomunale (big blind) collected (345)
Seat 7: kinnho007 folded before Flop (didn't bet)
Seat 8: GreenMohawk88 folded on the Flop
Seat 9: h_liminha folded on the Flop



PokerStars Home Game Hand #211087784738: {Club #3217684} Tournament #2845705715, 17000+3000 Hold'em No Limit - Level IV (30/60) - 2020/03/31 21:15:58 ET
Table '2845705715 1' 9-max Seat #5 is the button
Seat 1: FeGodines (9036 in chips) is sitting out
Seat 2: flagao (6994 in chips) 
Seat 3: SBocha (14415 in chips) 
Seat 4: Caduzzaum (6787 in chips) 
Seat 5: giovannifut (7655 in chips) 
Seat 6: fecomunale (8255 in chips) 
Seat 7: kinnho007 (12268 in chips) 
Seat 8: GreenMohawk88 (11330 in chips) 
Seat 9: h_liminha (13260 in chips) 
FeGodines: posts the ante 5
flagao: posts the ante 5
SBocha: posts the ante 5
Caduzzaum: posts the ante 5
giovannifut: posts the ante 5
fecomunale: posts the ante 5
kinnho007: posts the ante 5
GreenMohawk88: posts the ante 5
h_liminha: posts the ante 5
fecomunale: posts small blind 30
kinnho007: posts big blind 60
*** HOLE CARDS ***
Dealt to flagao [4h 7s]
GreenMohawk88 said, "jÃ¡ era rebuy?"
GreenMohawk88: calls 60
h_liminha: folds 
FeGodines: folds 
flagao: folds 
SBocha: folds 
Caduzzaum: folds 
giovannifut: raises 120 to 180
fecomunale: calls 150
GreenMohawk88 said, "tem mais rebuy ou ja era?"
kinnho007: raises 120 to 300
GreenMohawk88: calls 240
giovannifut: calls 120
GreenMohawk88 said, "kkkkk"
flagao said, "Ainda dÃ¡"
fecomunale: calls 120
*** FLOP *** [As 3d Ts]
fecomunale: checks 
SBocha said, "tem barba"
giovannifut said, "acho que tem amis 15 minutos"
kinnho007: bets 623
GreenMohawk88: folds 
giovannifut: calls 623
fecomunale: folds 
*** TURN *** [As 3d Ts] [5c]
kinnho007: bets 1246
giovannifut: calls 1246
*** RIVER *** [As 3d Ts 5c] [5d]
kinnho007: checks 
giovannifut: checks 
*** SHOW DOWN ***
kinnho007: shows [Ah Kd] (two pair, Aces and Fives)
giovannifut: mucks hand 
kinnho007 collected 4983 from pot
*** SUMMARY ***
Total pot 4983 | Rake 0 
Board [As 3d Ts 5c 5d]
Seat 1: FeGodines folded before Flop (didn't bet)
Seat 2: flagao folded before Flop (didn't bet)
Seat 3: SBocha folded before Flop (didn't bet)
Seat 4: Caduzzaum folded before Flop (didn't bet)
Seat 5: giovannifut (button) mucked [Ac Js]
Seat 6: fecomunale (small blind) folded on the Flop
Seat 7: kinnho007 (big blind) showed [Ah Kd] and won (4983) with two pair, Aces and Fives
Seat 8: GreenMohawk88 folded on the Flop
Seat 9: h_liminha folded before Flop (didn't bet)



PokerStars Home Game Hand #211087843854: {Club #3217684} Tournament #2845705715, 17000+3000 Hold'em No Limit - Level V (40/80) - 2020/03/31 21:17:23 ET
Table '2845705715 1' 9-max Seat #6 is the button
Seat 1: FeGodines (9031 in chips) is sitting out
Seat 2: flagao (6989 in chips) 
Seat 3: SBocha (14410 in chips) 
Seat 4: Caduzzaum (6782 in chips) 
Seat 5: giovannifut (5481 in chips) 
Seat 6: fecomunale (7950 in chips) 
Seat 7: kinnho007 (15077 in chips) 
Seat 8: GreenMohawk88 (11025 in chips) 
Seat 9: h_liminha (13255 in chips) 
FeGodines: posts the ante 10
flagao: posts the ante 10
SBocha: posts the ante 10
Caduzzaum: posts the ante 10
giovannifut: posts the ante 10
fecomunale: posts the ante 10
kinnho007: posts the ante 10
GreenMohawk88: posts the ante 10
h_liminha: posts the ante 10
kinnho007: posts small blind 40
GreenMohawk88: posts big blind 80
*** HOLE CARDS ***
Dealt to flagao [5h Js]
h_liminha: folds 
FeGodines: folds 
flagao: folds 
SBocha: calls 80
Caduzzaum: folds 
giovannifut: folds 
GreenMohawk88 said, "valeu"
fecomunale: folds 
kinnho007: calls 40
GreenMohawk88: checks 
*** FLOP *** [6s 4c 7c]
kinnho007: checks 
GreenMohawk88: checks 
SBocha: checks 
*** TURN *** [6s 4c 7c] [7d]
kinnho007: checks 
GreenMohawk88: checks 
SBocha: checks 
*** RIVER *** [6s 4c 7c 7d] [8h]
kinnho007: checks 
GreenMohawk88: bets 560
SBocha: folds 
kinnho007: folds 
Uncalled bet (560) returned to GreenMohawk88
GreenMohawk88 collected 330 from pot
GreenMohawk88: doesn't show hand 
*** SUMMARY ***
Total pot 330 | Rake 0 
Board [6s 4c 7c 7d 8h]
Seat 1: FeGodines folded before Flop (didn't bet)
Seat 2: flagao folded before Flop (didn't bet)
Seat 3: SBocha folded on the River
Seat 4: Caduzzaum folded before Flop (didn't bet)
Seat 5: giovannifut folded before Flop (didn't bet)
Seat 6: fecomunale (button) folded before Flop (didn't bet)
Seat 7: kinnho007 (small blind) folded on the River
Seat 8: GreenMohawk88 (big blind) collected (330)
Seat 9: h_liminha folded before Flop (didn't bet)



PokerStars Home Game Hand #211087891836: {Club #3217684} Tournament #2845705715, 17000+3000 Hold'em No Limit - Level V (40/80) - 2020/03/31 21:18:45 ET
Table '2845705715 1' 9-max Seat #7 is the button
Seat 1: FeGodines (9021 in chips) is sitting out
Seat 2: flagao (6979 in chips) 
Seat 3: SBocha (14320 in chips) 
Seat 4: Caduzzaum (6772 in chips) 
Seat 5: giovannifut (5471 in chips) 
Seat 6: fecomunale (7940 in chips) 
Seat 7: kinnho007 (14987 in chips) 
Seat 8: GreenMohawk88 (11265 in chips) 
Seat 9: h_liminha (13245 in chips) 
FeGodines: posts the ante 10
flagao: posts the ante 10
SBocha: posts the ante 10
Caduzzaum: posts the ante 10
giovannifut: posts the ante 10
fecomunale: posts the ante 10
kinnho007: posts the ante 10
GreenMohawk88: posts the ante 10
h_liminha: posts the ante 10
GreenMohawk88: posts small blind 40
h_liminha: posts big blind 80
*** HOLE CARDS ***
Dealt to flagao [As Qc]
FeGodines: folds 
flagao: raises 160 to 240
SBocha: folds 
Caduzzaum: folds 
giovannifut: folds 
fecomunale: folds 
kinnho007: folds 
GreenMohawk88: calls 200
h_liminha: calls 160
*** FLOP *** [5h 2s 2d]
GreenMohawk88: checks 
h_liminha: checks 
flagao: bets 240
GreenMohawk88: calls 240
h_liminha: folds 
*** TURN *** [5h 2s 2d] [3d]
GreenMohawk88: checks 
flagao: checks 
*** RIVER *** [5h 2s 2d 3d] [6s]
GreenMohawk88: checks 
flagao: checks 
*** SHOW DOWN ***
GreenMohawk88: shows [3c Ad] (two pair, Threes and Deuces)
flagao: mucks hand 
GreenMohawk88 collected 1290 from pot
*** SUMMARY ***
Total pot 1290 | Rake 0 
Board [5h 2s 2d 3d 6s]
Seat 1: FeGodines folded before Flop (didn't bet)
Seat 2: flagao mucked [As Qc]
Seat 3: SBocha folded before Flop (didn't bet)
Seat 4: Caduzzaum folded before Flop (didn't bet)
Seat 5: giovannifut folded before Flop (didn't bet)
Seat 6: fecomunale folded before Flop (didn't bet)
Seat 7: kinnho007 (button) folded before Flop (didn't bet)
Seat 8: GreenMohawk88 (small blind) showed [3c Ad] and won (1290) with two pair, Threes and Deuces
Seat 9: h_liminha (big blind) folded on the Flop



PokerStars Home Game Hand #211087925779: {Club #3217684} Tournament #2845705715, 17000+3000 Hold'em No Limit - Level V (40/80) - 2020/03/31 21:19:43 ET
Table '2845705715 1' 9-max Seat #8 is the button
Seat 1: FeGodines (9011 in chips) 
Seat 2: flagao (6489 in chips) 
Seat 3: SBocha (14310 in chips) 
Seat 4: Caduzzaum (6762 in chips) 
Seat 5: giovannifut (5461 in chips) 
Seat 6: fecomunale (7930 in chips) 
Seat 7: kinnho007 (14977 in chips) 
Seat 8: GreenMohawk88 (12065 in chips) 
Seat 9: h_liminha (12995 in chips) 
FeGodines: posts the ante 10
flagao: posts the ante 10
SBocha: posts the ante 10
Caduzzaum: posts the ante 10
giovannifut: posts the ante 10
fecomunale: posts the ante 10
kinnho007: posts the ante 10
GreenMohawk88: posts the ante 10
h_liminha: posts the ante 10
h_liminha: posts small blind 40
FeGodines: posts big blind 80
*** HOLE CARDS ***
Dealt to flagao [Kh Qc]
flagao: raises 80 to 160
SBocha: folds 
Caduzzaum: calls 160
giovannifut: calls 160
GreenMohawk88 said, "HAHAHAHA, foi foda, tava pela sequencia, ainda bem que virou o 3"
FeGodines said, "sinos belem?"
GreenMohawk88 said, "dessa vez nÃ£o"
fecomunale: raises 80 to 240
GreenMohawk88 said, "era sÃ³ o 4"
kinnho007: calls 240
GreenMohawk88: calls 240
h_liminha: folds 
FeGodines: calls 160
flagao: calls 80
Caduzzaum: calls 80
giovannifut: calls 80
*** FLOP *** [3s As 6h]
FeGodines: checks 
flagao: checks 
Caduzzaum: checks 
giovannifut: checks 
fecomunale: bets 905
kinnho007 said, "gosto de rapazes veiudos"
kinnho007: calls 905
GreenMohawk88: folds 
FeGodines: folds 
flagao: folds 
Caduzzaum: folds 
giovannifut: calls 905
*** TURN *** [3s As 6h] [Kc]
giovannifut: checks 
fecomunale: checks 
kinnho007: checks 
*** RIVER *** [3s As 6h Kc] [5d]
giovannifut: checks 
fecomunale: checks 
kinnho007: checks 
*** SHOW DOWN ***
giovannifut: shows [8s Qs] (high card Ace)
fecomunale: shows [9h 9s] (a pair of Nines)
kinnho007: mucks hand 
GreenMohawk88 said, "brincadeira, tinha K 5"
fecomunale collected 4525 from pot
*** SUMMARY ***
Total pot 4525 | Rake 0 
Board [3s As 6h Kc 5d]
Seat 1: FeGodines (big blind) folded on the Flop
Seat 2: flagao folded on the Flop
Seat 3: SBocha folded before Flop (didn't bet)
Seat 4: Caduzzaum folded on the Flop
Seat 5: giovannifut showed [8s Qs] and lost with high card Ace
Seat 6: fecomunale showed [9h 9s] and won (4525) with a pair of Nines
Seat 7: kinnho007 mucked [Js 5s]
Seat 8: GreenMohawk88 (button) folded on the Flop
Seat 9: h_liminha (small blind) folded before Flop



PokerStars Home Game Hand #211088022943: {Club #3217684} Tournament #2845705715, 17000+3000 Hold'em No Limit - Level V (40/80) - 2020/03/31 21:22:27 ET
Table '2845705715 1' 9-max Seat #9 is the button
Seat 1: FeGodines (8761 in chips) 
Seat 2: flagao (6239 in chips) 
Seat 3: SBocha (14300 in chips) 
Seat 4: Caduzzaum (6512 in chips) 
Seat 5: giovannifut (4306 in chips) 
Seat 6: fecomunale (11300 in chips) 
Seat 7: kinnho007 (13822 in chips) 
Seat 8: GreenMohawk88 (11815 in chips) 
Seat 9: h_liminha (12945 in chips) 
FeGodines: posts the ante 10
flagao: posts the ante 10
SBocha: posts the ante 10
Caduzzaum: posts the ante 10
giovannifut: posts the ante 10
fecomunale: posts the ante 10
kinnho007: posts the ante 10
GreenMohawk88: posts the ante 10
h_liminha: posts the ante 10
FeGodines: posts small blind 40
flagao: posts big blind 80
*** HOLE CARDS ***
Dealt to flagao [Jd Qd]
SBocha: folds 
Caduzzaum: folds 
giovannifut: folds 
fecomunale: raises 80 to 160
kinnho007: calls 160
GreenMohawk88: calls 160
h_liminha: calls 160
FeGodines: calls 120
flagao: calls 80
*** FLOP *** [Js 3c 6h]
FeGodines: checks 
flagao: bets 240
fecomunale: calls 240
kinnho007: folds 
GreenMohawk88: folds 
h_liminha: folds 
FeGodines: calls 240
*** TURN *** [Js 3c 6h] [Qh]
FeGodines: checks 
flagao: bets 480
fecomunale: calls 480
FeGodines: calls 480
*** RIVER *** [Js 3c 6h Qh] [Qc]
FeGodines: checks 
flagao: bets 800
fecomunale: folds 
FeGodines: folds 
Uncalled bet (800) returned to flagao
flagao collected 3210 from pot
flagao: doesn't show hand 
*** SUMMARY ***
Total pot 3210 | Rake 0 
Board [Js 3c 6h Qh Qc]
Seat 1: FeGodines (small blind) folded on the River
Seat 2: flagao (big blind) collected (3210)
Seat 3: SBocha folded before Flop (didn't bet)
Seat 4: Caduzzaum folded before Flop (didn't bet)
Seat 5: giovannifut folded before Flop (didn't bet)
Seat 6: fecomunale folded on the River
Seat 7: kinnho007 folded on the Flop
Seat 8: GreenMohawk88 folded on the Flop
Seat 9: h_liminha (button) folded on the Flop



PokerStars Home Game Hand #211088073920: {Club #3217684} Tournament #2845705715, 17000+3000 Hold'em No Limit - Level V (40/80) - 2020/03/31 21:23:50 ET
Table '2845705715 1' 9-max Seat #1 is the button
Seat 1: FeGodines (7871 in chips) 
Seat 2: flagao (8559 in chips) 
Seat 3: SBocha (14290 in chips) 
Seat 4: Caduzzaum (6502 in chips) 
Seat 5: giovannifut (4296 in chips) 
Seat 6: fecomunale (10410 in chips) 
Seat 7: kinnho007 (13652 in chips) 
Seat 8: GreenMohawk88 (11645 in chips) 
Seat 9: h_liminha (12775 in chips) 
FeGodines: posts the ante 10
flagao: posts the ante 10
SBocha: posts the ante 10
Caduzzaum: posts the ante 10
giovannifut: posts the ante 10
fecomunale: posts the ante 10
kinnho007: posts the ante 10
GreenMohawk88: posts the ante 10
h_liminha: posts the ante 10
flagao: posts small blind 40
SBocha: posts big blind 80
*** HOLE CARDS ***
Dealt to flagao [2c 4c]
Caduzzaum: folds 
giovannifut: folds 
fecomunale: folds 
kinnho007: calls 80
GreenMohawk88: folds 
h_liminha: calls 80
FeGodines: folds 
flagao: folds 
SBocha: checks 
*** FLOP *** [Qs Ah Ks]
SBocha: checks 
kinnho007: bets 185
h_liminha: calls 185
SBocha: calls 185
*** TURN *** [Qs Ah Ks] [5d]
SBocha: checks 
kinnho007: bets 463
h_liminha: calls 463
SBocha: folds 
*** RIVER *** [Qs Ah Ks 5d] [Jc]
kinnho007: checks 
h_liminha: bets 560
kinnho007: calls 560
*** SHOW DOWN ***
h_liminha: shows [Ts 7s] (a straight, Ten to Ace)
kinnho007: mucks hand 
h_liminha collected 2971 from pot
*** SUMMARY ***
Total pot 2971 | Rake 0 
Board [Qs Ah Ks 5d Jc]
Seat 1: FeGodines (button) folded before Flop (didn't bet)
Seat 2: flagao (small blind) folded before Flop
Seat 3: SBocha (big blind) folded on the Turn
Seat 4: Caduzzaum folded before Flop (didn't bet)
Seat 5: giovannifut folded before Flop (didn't bet)
Seat 6: fecomunale folded before Flop (didn't bet)
Seat 7: kinnho007 mucked [As 3s]
Seat 8: GreenMohawk88 folded before Flop (didn't bet)
Seat 9: h_liminha showed [Ts 7s] and won (2971) with a straight, Ten to Ace



PokerStars Home Game Hand #211088129368: {Club #3217684} Tournament #2845705715, 17000+3000 Hold'em No Limit - Level V (40/80) - 2020/03/31 21:25:25 ET
Table '2845705715 1' 9-max Seat #2 is the button
Seat 1: FeGodines (7861 in chips) 
Seat 2: flagao (8509 in chips) 
Seat 3: SBocha (14015 in chips) 
Seat 4: Caduzzaum (6492 in chips) 
Seat 5: giovannifut (4286 in chips) 
Seat 6: fecomunale (10400 in chips) 
Seat 7: kinnho007 (12354 in chips) 
Seat 8: GreenMohawk88 (11635 in chips) 
Seat 9: h_liminha (14448 in chips) 
FeGodines: posts the ante 10
flagao: posts the ante 10
SBocha: posts the ante 10
Caduzzaum: posts the ante 10
giovannifut: posts the ante 10
fecomunale: posts the ante 10
kinnho007: posts the ante 10
GreenMohawk88: posts the ante 10
h_liminha: posts the ante 10
SBocha: posts small blind 40
Caduzzaum: posts big blind 80
*** HOLE CARDS ***
Dealt to flagao [Qs Ac]
giovannifut: folds 
fecomunale: calls 80
kinnho007: folds 
GreenMohawk88: calls 80
h_liminha is disconnected 
h_liminha has timed out while disconnected
h_liminha: folds 
FeGodines: folds 
flagao: raises 160 to 240
SBocha: folds 
Caduzzaum: folds 
fecomunale: calls 160
GreenMohawk88 said, "deve ser do Massa"
GreenMohawk88: calls 160
*** FLOP *** [6c Ad 8d]
fecomunale: checks 
GreenMohawk88: bets 160
flagao: raises 320 to 480
GreenMohawk88 said, "eish"
fecomunale: calls 480
GreenMohawk88: calls 320
*** TURN *** [6c Ad 8d] [5d]
fecomunale: checks 
GreenMohawk88: bets 720
flagao: calls 720
fecomunale: calls 720
*** RIVER *** [6c Ad 8d 5d] [3h]
fecomunale: checks 
GreenMohawk88: checks 
flagao: checks 
*** SHOW DOWN ***
fecomunale: shows [Ah 3d] (two pair, Aces and Threes)
GreenMohawk88: shows [4d Jd] (a flush, Ace high)
flagao: mucks hand 
GreenMohawk88 collected 4530 from pot
*** SUMMARY ***
Total pot 4530 | Rake 0 
Board [6c Ad 8d 5d 3h]
Seat 1: FeGodines folded before Flop (didn't bet)
Seat 2: flagao (button) mucked [Qs Ac]
Seat 3: SBocha (small blind) folded before Flop
Seat 4: Caduzzaum (big blind) folded before Flop
Seat 5: giovannifut folded before Flop (didn't bet)
Seat 6: fecomunale showed [Ah 3d] and lost with two pair, Aces and Threes
Seat 7: kinnho007 folded before Flop (didn't bet)
Seat 8: GreenMohawk88 showed [4d Jd] and won (4530) with a flush, Ace high
Seat 9: h_liminha folded before Flop (didn't bet)



PokerStars Home Game Hand #211088221557: {Club #3217684} Tournament #2845705715, 17000+3000 Hold'em No Limit - Level VI (50/100) - 2020/03/31 21:27:55 ET
Table '2845705715 1' 9-max Seat #3 is the button
Seat 1: FeGodines (7851 in chips) 
Seat 2: flagao (7059 in chips) 
Seat 3: SBocha (13965 in chips) 
Seat 4: Caduzzaum (6402 in chips) 
Seat 5: giovannifut (4276 in chips) 
Seat 6: fecomunale (8950 in chips) 
Seat 7: kinnho007 (12344 in chips) 
Seat 8: GreenMohawk88 (14715 in chips) 
Seat 9: h_liminha (14438 in chips) is sitting out
FeGodines: posts the ante 10
flagao: posts the ante 10
SBocha: posts the ante 10
Caduzzaum: posts the ante 10
giovannifut: posts the ante 10
fecomunale: posts the ante 10
kinnho007: posts the ante 10
GreenMohawk88: posts the ante 10
h_liminha: posts the ante 10
Caduzzaum: posts small blind 50
giovannifut: posts big blind 100
*** HOLE CARDS ***
Dealt to flagao [4h 9c]
GreenMohawk88 said, "kkkk"
GreenMohawk88 said, "pensei que voce ia apostar alto agora"
GreenMohawk88 said, "por isso passei"
fecomunale: folds 
kinnho007: calls 100
GreenMohawk88: folds 
flagao said, "Com o flush na mesa nÃ£o tinha como"
h_liminha: folds 
FeGodines: folds 
flagao: folds 
SBocha: calls 100
Caduzzaum: calls 50
giovannifut: raises 300 to 400
kinnho007: folds 
SBocha: calls 300
Caduzzaum: folds 
*** FLOP *** [4d 7c 9h]
giovannifut: bets 1600
SBocha: folds 
Uncalled bet (1600) returned to giovannifut
giovannifut collected 1090 from pot
giovannifut: doesn't show hand 
*** SUMMARY ***
Total pot 1090 | Rake 0 
Board [4d 7c 9h]
Seat 1: FeGodines folded before Flop (didn't bet)
Seat 2: flagao folded before Flop (didn't bet)
Seat 3: SBocha (button) folded on the Flop
Seat 4: Caduzzaum (small blind) folded before Flop
Seat 5: giovannifut (big blind) collected (1090)
Seat 6: fecomunale folded before Flop (didn't bet)
Seat 7: kinnho007 folded before Flop
Seat 8: GreenMohawk88 folded before Flop (didn't bet)
Seat 9: h_liminha folded before Flop (didn't bet)



PokerStars Home Game Hand #211088282090: {Club #3217684} Tournament #2845705715, 17000+3000 Hold'em No Limit - Level VI (50/100) - 2020/03/31 21:29:40 ET
Table '2845705715 1' 9-max Seat #4 is the button
Seat 1: FeGodines (7841 in chips) 
Seat 2: flagao (7049 in chips) 
Seat 3: SBocha (13555 in chips) 
Seat 4: Caduzzaum (6292 in chips) 
Seat 5: giovannifut (4956 in chips) 
Seat 6: fecomunale (8940 in chips) 
Seat 7: kinnho007 (12234 in chips) 
Seat 8: GreenMohawk88 (14705 in chips) 
Seat 9: h_liminha (14428 in chips) 
FeGodines: posts the ante 10
flagao: posts the ante 10
SBocha: posts the ante 10
Caduzzaum: posts the ante 10
giovannifut: posts the ante 10
fecomunale: posts the ante 10
kinnho007: posts the ante 10
GreenMohawk88: posts the ante 10
h_liminha: posts the ante 10
giovannifut: posts small blind 50
fecomunale: posts big blind 100
*** HOLE CARDS ***
Dealt to flagao [5d 7c]
kinnho007: folds 
GreenMohawk88: calls 100
h_liminha: folds 
FeGodines: calls 100
flagao: folds 
SBocha: folds 
Caduzzaum: folds 
giovannifut: calls 50
fecomunale: checks 
*** FLOP *** [6h Jh 6c]
giovannifut: checks 
fecomunale: checks 
GreenMohawk88: checks 
FeGodines: checks 
*** TURN *** [6h Jh 6c] [2c]
giovannifut: checks 
fecomunale: checks 
GreenMohawk88: bets 300
FeGodines: calls 300
giovannifut: folds 
fecomunale: folds 
*** RIVER *** [6h Jh 6c 2c] [Ad]
GreenMohawk88: checks 
FeGodines: checks 
*** SHOW DOWN ***
GreenMohawk88: shows [7h Qc] (a pair of Sixes)
FeGodines: shows [4s 4c] (two pair, Sixes and Fours)
FeGodines collected 1090 from pot
*** SUMMARY ***
Total pot 1090 | Rake 0 
Board [6h Jh 6c 2c Ad]
Seat 1: FeGodines showed [4s 4c] and won (1090) with two pair, Sixes and Fours
Seat 2: flagao folded before Flop (didn't bet)
Seat 3: SBocha folded before Flop (didn't bet)
Seat 4: Caduzzaum (button) folded before Flop (didn't bet)
Seat 5: giovannifut (small blind) folded on the Turn
Seat 6: fecomunale (big blind) folded on the Turn
Seat 7: kinnho007 folded before Flop (didn't bet)
Seat 8: GreenMohawk88 showed [7h Qc] and lost with a pair of Sixes
Seat 9: h_liminha folded before Flop (didn't bet)



PokerStars Home Game Hand #211088313252: {Club #3217684} Tournament #2845705715, 17000+3000 Hold'em No Limit - Level VI (50/100) - 2020/03/31 21:30:32 ET
Table '2845705715 1' 9-max Seat #5 is the button
Seat 1: FeGodines (8521 in chips) 
Seat 2: flagao (7039 in chips) 
Seat 3: SBocha (13545 in chips) 
Seat 4: Caduzzaum (6282 in chips) 
Seat 5: giovannifut (4846 in chips) 
Seat 6: fecomunale (8830 in chips) 
Seat 7: kinnho007 (12224 in chips) 
Seat 8: GreenMohawk88 (14295 in chips) 
Seat 9: h_liminha (14418 in chips) 
FeGodines: posts the ante 10
flagao: posts the ante 10
SBocha: posts the ante 10
Caduzzaum: posts the ante 10
giovannifut: posts the ante 10
fecomunale: posts the ante 10
kinnho007: posts the ante 10
GreenMohawk88: posts the ante 10
h_liminha: posts the ante 10
fecomunale: posts small blind 50
kinnho007: posts big blind 100
*** HOLE CARDS ***
Dealt to flagao [Kd 6c]
GreenMohawk88 said, "kkkkkkkk"
GreenMohawk88: folds 
h_liminha: folds 
FeGodines: raises 150 to 250
flagao: folds 
SBocha: folds 
GreenMohawk88 said, "yeah"
Caduzzaum: calls 250
giovannifut: calls 250
fecomunale: calls 200
kinnho007: folds 
*** FLOP *** [3s 3c Ts]
fecomunale: checks 
FeGodines: bets 381
Caduzzaum: raises 381 to 762
giovannifut: raises 3824 to 4586 and is all-in
fecomunale: folds 
FeGodines: folds 
Caduzzaum: folds [Js 7s]
Uncalled bet (3824) returned to giovannifut
giovannifut collected 3095 from pot
giovannifut: doesn't show hand 
*** SUMMARY ***
Total pot 3095 | Rake 0 
Board [3s 3c Ts]
Seat 1: FeGodines folded on the Flop
Seat 2: flagao folded before Flop (didn't bet)
Seat 3: SBocha folded before Flop (didn't bet)
Seat 4: Caduzzaum folded on the Flop
Seat 5: giovannifut (button) collected (3095)
Seat 6: fecomunale (small blind) folded on the Flop
Seat 7: kinnho007 (big blind) folded before Flop
Seat 8: GreenMohawk88 folded before Flop (didn't bet)
Seat 9: h_liminha folded before Flop (didn't bet)



PokerStars Home Game Hand #211088376244: {Club #3217684} Tournament #2845705715, 17000+3000 Hold'em No Limit - Level VI (50/100) - 2020/03/31 21:32:10 ET
Table '2845705715 1' 9-max Seat #6 is the button
Seat 1: FeGodines (7880 in chips) 
Seat 2: flagao (7029 in chips) 
Seat 3: SBocha (13535 in chips) 
Seat 4: Caduzzaum (5260 in chips) 
Seat 5: giovannifut (6919 in chips) 
Seat 6: fecomunale (8570 in chips) 
Seat 7: kinnho007 (12114 in chips) 
Seat 8: GreenMohawk88 (14285 in chips) 
Seat 9: h_liminha (14408 in chips) 
FeGodines: posts the ante 10
flagao: posts the ante 10
SBocha: posts the ante 10
Caduzzaum: posts the ante 10
giovannifut: posts the ante 10
fecomunale: posts the ante 10
kinnho007: posts the ante 10
GreenMohawk88: posts the ante 10
h_liminha: posts the ante 10
kinnho007: posts small blind 50
GreenMohawk88: posts big blind 100
*** HOLE CARDS ***
Dealt to flagao [3d 9h]
h_liminha: folds 
FeGodines: folds 
flagao: folds 
SBocha: folds 
Caduzzaum: folds 
giovannifut: calls 100
fecomunale: folds 
kinnho007: calls 50
GreenMohawk88: checks 
*** FLOP *** [Kh Qh Ks]
kinnho007: checks 
GreenMohawk88 said, "eita le le"
GreenMohawk88: checks 
giovannifut: checks 
*** TURN *** [Kh Qh Ks] [5h]
kinnho007: checks 
GreenMohawk88: checks 
giovannifut: bets 300
kinnho007: folds 
GreenMohawk88: folds 
Uncalled bet (300) returned to giovannifut
giovannifut collected 390 from pot
giovannifut: doesn't show hand 
GreenMohawk88 said, "kkkkk"
*** SUMMARY ***
Total pot 390 | Rake 0 
Board [Kh Qh Ks 5h]
Seat 1: FeGodines folded before Flop (didn't bet)
Seat 2: flagao folded before Flop (didn't bet)
Seat 3: SBocha folded before Flop (didn't bet)
Seat 4: Caduzzaum folded before Flop (didn't bet)
Seat 5: giovannifut collected (390)
Seat 6: fecomunale (button) folded before Flop (didn't bet)
Seat 7: kinnho007 (small blind) folded on the Turn
Seat 8: GreenMohawk88 (big blind) folded on the Turn
Seat 9: h_liminha folded before Flop (didn't bet)



PokerStars Home Game Hand #211088422961: {Club #3217684} Tournament #2845705715, 17000+3000 Hold'em No Limit - Level VI (50/100) - 2020/03/31 21:33:31 ET
Table '2845705715 1' 9-max Seat #7 is the button
Seat 1: FeGodines (7870 in chips) 
Seat 2: flagao (7019 in chips) 
Seat 3: SBocha (13525 in chips) 
Seat 4: Caduzzaum (5250 in chips) 
Seat 5: giovannifut (7199 in chips) 
Seat 6: fecomunale (8560 in chips) 
Seat 7: kinnho007 (12004 in chips) 
Seat 8: GreenMohawk88 (14175 in chips) 
Seat 9: h_liminha (14398 in chips) 
FeGodines: posts the ante 10
flagao: posts the ante 10
SBocha: posts the ante 10
Caduzzaum: posts the ante 10
giovannifut: posts the ante 10
fecomunale: posts the ante 10
kinnho007: posts the ante 10
GreenMohawk88: posts the ante 10
h_liminha: posts the ante 10
GreenMohawk88: posts small blind 50
h_liminha: posts big blind 100
*** HOLE CARDS ***
Dealt to flagao [2h 7h]
FeGodines: folds 
flagao: folds 
SBocha: folds 
Caduzzaum: folds 
giovannifut: calls 100
GreenMohawk88 said, "eu nÃ£o gravei outro"
GreenMohawk88 said, "o que tem gravado eu to treinando com cueca kkkk"
GreenMohawk88 said, "uhauhahua"
GreenMohawk88 said, "kkkkk"
fecomunale: folds 
kinnho007: folds 
GreenMohawk88: calls 50
h_liminha: checks 
*** FLOP *** [7c Jd Ac]
GreenMohawk88: checks 
h_liminha: checks 
giovannifut: checks 
*** TURN *** [7c Jd Ac] [Jc]
GreenMohawk88: checks 
h_liminha: checks 
giovannifut: bets 300
GreenMohawk88: folds 
h_liminha: folds 
Uncalled bet (300) returned to giovannifut
giovannifut collected 390 from pot
giovannifut: doesn't show hand 
*** SUMMARY ***
Total pot 390 | Rake 0 
Board [7c Jd Ac Jc]
Seat 1: FeGodines folded before Flop (didn't bet)
Seat 2: flagao folded before Flop (didn't bet)
Seat 3: SBocha folded before Flop (didn't bet)
Seat 4: Caduzzaum folded before Flop (didn't bet)
Seat 5: giovannifut collected (390)
Seat 6: fecomunale folded before Flop (didn't bet)
Seat 7: kinnho007 (button) folded before Flop (didn't bet)
Seat 8: GreenMohawk88 (small blind) folded on the Turn
Seat 9: h_liminha (big blind) folded on the Turn



PokerStars Home Game Hand #211088476711: {Club #3217684} Tournament #2845705715, 17000+3000 Hold'em No Limit - Level VI (50/100) - 2020/03/31 21:35:04 ET
Table '2845705715 1' 9-max Seat #8 is the button
Seat 1: FeGodines (7860 in chips) 
Seat 2: flagao (7009 in chips) 
Seat 3: SBocha (13515 in chips) 
Seat 4: Caduzzaum (5240 in chips) 
Seat 5: giovannifut (7479 in chips) 
Seat 6: fecomunale (8550 in chips) 
Seat 7: kinnho007 (11994 in chips) 
Seat 8: GreenMohawk88 (14065 in chips) 
Seat 9: h_liminha (14288 in chips) 
FeGodines: posts the ante 10
flagao: posts the ante 10
SBocha: posts the ante 10
Caduzzaum: posts the ante 10
giovannifut: posts the ante 10
fecomunale: posts the ante 10
kinnho007: posts the ante 10
GreenMohawk88: posts the ante 10
h_liminha: posts the ante 10
h_liminha: posts small blind 50
FeGodines: posts big blind 100
*** HOLE CARDS ***
Dealt to flagao [Jd 5h]
flagao: folds 
SBocha: folds 
Caduzzaum: raises 100 to 200
giovannifut: folds 
fecomunale is disconnected 
fecomunale is connected 
fecomunale: calls 200
kinnho007: raises 840 to 1040
GreenMohawk88: calls 1040
h_liminha: folds 
FeGodines: folds 
GreenMohawk88 said, "Kinho safado"
Caduzzaum: folds 
fecomunale: folds 
*** FLOP *** [5s 8s 6h]
kinnho007: bets 1360
kinnho007 said, "kkkkkkkk"
GreenMohawk88 said, "ossada"
GreenMohawk88: folds 
Uncalled bet (1360) returned to kinnho007
kinnho007 collected 2720 from pot
kinnho007: doesn't show hand 
*** SUMMARY ***
Total pot 2720 | Rake 0 
Board [5s 8s 6h]
Seat 1: FeGodines (big blind) folded before Flop
Seat 2: flagao folded before Flop (didn't bet)
Seat 3: SBocha folded before Flop (didn't bet)
Seat 4: Caduzzaum folded before Flop
Seat 5: giovannifut folded before Flop (didn't bet)
Seat 6: fecomunale folded before Flop
Seat 7: kinnho007 collected (2720)
Seat 8: GreenMohawk88 (button) folded on the Flop
Seat 9: h_liminha (small blind) folded before Flop



PokerStars Home Game Hand #211088735131: {Club #3217684} Tournament #2845705715, 17000+3000 Hold'em No Limit - Level VII (60/120) - 2020/03/31 21:41:58 ET
Table '2845705715 1' 9-max Seat #9 is the button
Seat 1: FeGodines (7750 in chips) 
Seat 2: flagao (6999 in chips) 
Seat 3: SBocha (13505 in chips) 
Seat 4: Caduzzaum (5030 in chips) 
Seat 5: giovannifut (7469 in chips) 
Seat 6: fecomunale (8340 in chips) 
Seat 7: kinnho007 (13664 in chips) 
Seat 8: GreenMohawk88 (13015 in chips) 
Seat 9: h_liminha (14228 in chips) 
FeGodines: posts the ante 15
flagao: posts the ante 15
SBocha: posts the ante 15
Caduzzaum: posts the ante 15
giovannifut: posts the ante 15
fecomunale: posts the ante 15
kinnho007: posts the ante 15
GreenMohawk88: posts the ante 15
h_liminha: posts the ante 15
FeGodines: posts small blind 60
flagao: posts big blind 120
*** HOLE CARDS ***
Dealt to flagao [8h Qd]
SBocha: folds 
Caduzzaum: folds 
giovannifut: calls 120
fecomunale: raises 120 to 240
kinnho007: calls 240
GreenMohawk88: calls 240
h_liminha: calls 240
FeGodines: calls 180
flagao: folds 
giovannifut: calls 120
*** FLOP *** [2d 7d 4s]
FeGodines: checks 
giovannifut: bets 1000
fecomunale: calls 1000
kinnho007: folds 
GreenMohawk88: calls 1000
h_liminha: folds 
FeGodines: folds 
*** TURN *** [2d 7d 4s] [Qh]
giovannifut: bets 2348
fecomunale: folds 
GreenMohawk88 said, "viado"
GreenMohawk88: calls 2348
*** RIVER *** [2d 7d 4s Qh] [5c]
giovannifut: bets 3866 and is all-in
GreenMohawk88: folds 
Uncalled bet (3866) returned to giovannifut
GreenMohawk88 said, "tava pelo flush"
giovannifut collected 9391 from pot
giovannifut: doesn't show hand 
*** SUMMARY ***
Total pot 9391 | Rake 0 
Board [2d 7d 4s Qh 5c]
Seat 1: FeGodines (small blind) folded on the Flop
Seat 2: flagao (big blind) folded before Flop
Seat 3: SBocha folded before Flop (didn't bet)
Seat 4: Caduzzaum folded before Flop (didn't bet)
Seat 5: giovannifut collected (9391)
Seat 6: fecomunale folded on the Turn
Seat 7: kinnho007 folded on the Flop
Seat 8: GreenMohawk88 folded on the River
Seat 9: h_liminha (button) folded on the Flop



PokerStars Home Game Hand #211088808295: {Club #3217684} Tournament #2845705715, 17000+3000 Hold'em No Limit - Level VII (60/120) - 2020/03/31 21:44:04 ET
Table '2845705715 1' 9-max Seat #1 is the button
Seat 1: FeGodines (7495 in chips) 
Seat 2: flagao (6864 in chips) 
Seat 3: SBocha (13490 in chips) 
Seat 5: giovannifut (13257 in chips) 
Seat 6: fecomunale (7085 in chips) 
Seat 7: kinnho007 (13409 in chips) 
Seat 8: GreenMohawk88 (9412 in chips) 
Seat 9: h_liminha (13973 in chips) 
FeGodines: posts the ante 15
flagao: posts the ante 15
SBocha: posts the ante 15
giovannifut: posts the ante 15
fecomunale: posts the ante 15
kinnho007: posts the ante 15
GreenMohawk88: posts the ante 15
h_liminha: posts the ante 15
flagao: posts small blind 60
SBocha: posts big blind 120
*** HOLE CARDS ***
Dealt to flagao [2h Th]
giovannifut: folds 
fecomunale: folds 
kinnho007: folds 
GreenMohawk88: folds 
h_liminha: folds 
FeGodines: folds 
flagao: raises 240 to 360
SBocha: calls 240
*** FLOP *** [Ts 4s Qc]
flagao: bets 360
SBocha: calls 360
*** TURN *** [Ts 4s Qc] [Jh]
flagao: checks 
SBocha: bets 600
flagao: folds 
Uncalled bet (600) returned to SBocha
SBocha collected 1560 from pot
SBocha: doesn't show hand 
*** SUMMARY ***
Total pot 1560 | Rake 0 
Board [Ts 4s Qc Jh]
Seat 1: FeGodines (button) folded before Flop (didn't bet)
Seat 2: flagao (small blind) folded on the Turn
Seat 3: SBocha (big blind) collected (1560)
Seat 5: giovannifut folded before Flop (didn't bet)
Seat 6: fecomunale folded before Flop (didn't bet)
Seat 7: kinnho007 folded before Flop (didn't bet)
Seat 8: GreenMohawk88 folded before Flop (didn't bet)
Seat 9: h_liminha folded before Flop (didn't bet)



PokerStars Home Game Hand #211088859965: {Club #3217684} Tournament #2845705715, 17000+3000 Hold'em No Limit - Level VII (60/120) - 2020/03/31 21:45:33 ET
Table '2845705715 1' 9-max Seat #2 is the button
Seat 1: FeGodines (7480 in chips) 
Seat 2: flagao (6129 in chips) 
Seat 3: SBocha (14315 in chips) 
Seat 5: giovannifut (13242 in chips) 
Seat 6: fecomunale (7070 in chips) 
Seat 7: kinnho007 (13394 in chips) 
Seat 8: GreenMohawk88 (9397 in chips) 
Seat 9: h_liminha (13958 in chips) 
FeGodines: posts the ante 15
flagao: posts the ante 15
SBocha: posts the ante 15
giovannifut: posts the ante 15
fecomunale: posts the ante 15
kinnho007: posts the ante 15
GreenMohawk88: posts the ante 15
h_liminha: posts the ante 15
SBocha: posts small blind 60
giovannifut: posts big blind 120
*** HOLE CARDS ***
Dealt to flagao [4d Ah]
fecomunale: raises 240 to 360
kinnho007: folds 
GreenMohawk88: folds 
h_liminha: raises 240 to 600
FeGodines: folds 
flagao: folds 
SBocha: folds 
giovannifut: folds 
fecomunale: calls 240
*** FLOP *** [3d Jh 2h]
fecomunale: bets 750
h_liminha: calls 750
*** TURN *** [3d Jh 2h] [6h]
fecomunale: checks 
h_liminha: bets 840
fecomunale: folds 
Uncalled bet (840) returned to h_liminha
h_liminha collected 3000 from pot
h_liminha: doesn't show hand 
*** SUMMARY ***
Total pot 3000 | Rake 0 
Board [3d Jh 2h 6h]
Seat 1: FeGodines folded before Flop (didn't bet)
Seat 2: flagao (button) folded before Flop (didn't bet)
Seat 3: SBocha (small blind) folded before Flop
Seat 5: giovannifut (big blind) folded before Flop
Seat 6: fecomunale folded on the Turn
Seat 7: kinnho007 folded before Flop (didn't bet)
Seat 8: GreenMohawk88 folded before Flop (didn't bet)
Seat 9: h_liminha collected (3000)



PokerStars Home Game Hand #211088919009: {Club #3217684} Tournament #2845705715, 17000+3000 Hold'em No Limit - Level VII (60/120) - 2020/03/31 21:46:58 ET
Table '2845705715 1' 9-max Seat #3 is the button
Seat 1: FeGodines (7465 in chips) 
Seat 2: flagao (6114 in chips) 
Seat 3: SBocha (14240 in chips) 
Seat 5: giovannifut (13107 in chips) 
Seat 6: fecomunale (5705 in chips) 
Seat 7: kinnho007 (13379 in chips) 
Seat 8: GreenMohawk88 (9382 in chips) 
Seat 9: h_liminha (15593 in chips) 
FeGodines: posts the ante 15
flagao: posts the ante 15
SBocha: posts the ante 15
giovannifut: posts the ante 15
fecomunale: posts the ante 15
kinnho007: posts the ante 15
GreenMohawk88: posts the ante 15
h_liminha: posts the ante 15
giovannifut: posts small blind 60
fecomunale: posts big blind 120
*** HOLE CARDS ***
Dealt to flagao [Ah Qc]
kinnho007: calls 120
GreenMohawk88: folds 
flagao said, "QQ fefe?"
h_liminha: folds 
FeGodines: calls 120
flagao: raises 240 to 360
SBocha: folds 
giovannifut: folds 
fecomunale: folds 
kinnho007: calls 240
FeGodines: calls 240
*** FLOP *** [7s Ks 9c]
kinnho007: checks 
FeGodines: checks 
flagao: bets 480
kinnho007: folds 
FeGodines: calls 480
*** TURN *** [7s Ks 9c] [4h]
FeGodines: checks 
flagao: checks 
*** RIVER *** [7s Ks 9c 4h] [3c]
FeGodines: checks 
flagao: bets 1200
FeGodines: calls 1200
*** SHOW DOWN ***
flagao: shows [Ah Qc] (high card Ace)
FeGodines: shows [Tc 9s] (a pair of Nines)
FeGodines collected 4740 from pot
*** SUMMARY ***
Total pot 4740 | Rake 0 
Board [7s Ks 9c 4h 3c]
Seat 1: FeGodines showed [Tc 9s] and won (4740) with a pair of Nines
Seat 2: flagao showed [Ah Qc] and lost with high card Ace
Seat 3: SBocha (button) folded before Flop (didn't bet)
Seat 5: giovannifut (small blind) folded before Flop
Seat 6: fecomunale (big blind) folded before Flop
Seat 7: kinnho007 folded on the Flop
Seat 8: GreenMohawk88 folded before Flop (didn't bet)
Seat 9: h_liminha folded before Flop (didn't bet)



PokerStars Home Game Hand #211088965103: {Club #3217684} Tournament #2845705715, 17000+3000 Hold'em No Limit - Level VII (60/120) - 2020/03/31 21:48:18 ET
Table '2845705715 1' 9-max Seat #5 is the button
Seat 1: FeGodines (10150 in chips) 
Seat 2: flagao (4059 in chips) 
Seat 3: SBocha (14225 in chips) 
Seat 5: giovannifut (13032 in chips) 
Seat 6: fecomunale (5570 in chips) 
Seat 7: kinnho007 (13004 in chips) 
Seat 8: GreenMohawk88 (9367 in chips) 
Seat 9: h_liminha (15578 in chips) 
FeGodines: posts the ante 15
flagao: posts the ante 15
SBocha: posts the ante 15
giovannifut: posts the ante 15
fecomunale: posts the ante 15
kinnho007: posts the ante 15
GreenMohawk88: posts the ante 15
h_liminha: posts the ante 15
fecomunale: posts small blind 60
kinnho007: posts big blind 120
*** HOLE CARDS ***
Dealt to flagao [Kc Kd]
GreenMohawk88: folds 
h_liminha: folds 
FeGodines: calls 120
flagao: raises 360 to 480
SBocha: folds 
giovannifut: calls 480
fecomunale: calls 420
kinnho007: calls 360
FeGodines: calls 360
*** FLOP *** [Qs As 7d]
fecomunale: checks 
kinnho007: bets 1260
FeGodines: folds 
flagao: calls 1260
giovannifut: folds 
fecomunale: folds 
*** TURN *** [Qs As 7d] [2s]
kinnho007: checks 
flagao: bets 2304 and is all-in
kinnho007: folds 
Uncalled bet (2304) returned to flagao
flagao collected 5040 from pot
flagao: doesn't show hand 
*** SUMMARY ***
Total pot 5040 | Rake 0 
Board [Qs As 7d 2s]
Seat 1: FeGodines folded on the Flop
Seat 2: flagao collected (5040)
Seat 3: SBocha folded before Flop (didn't bet)
Seat 5: giovannifut (button) folded on the Flop
Seat 6: fecomunale (small blind) folded on the Flop
Seat 7: kinnho007 (big blind) folded on the Turn
Seat 8: GreenMohawk88 folded before Flop (didn't bet)
Seat 9: h_liminha folded before Flop (didn't bet)



PokerStars Home Game Hand #211089048931: {Club #3217684} Tournament #2845705715, 17000+3000 Hold'em No Limit - Level VII (60/120) - 2020/03/31 21:50:45 ET
Table '2845705715 1' 9-max Seat #6 is the button
Seat 1: FeGodines (9655 in chips) 
Seat 2: flagao (7344 in chips) 
Seat 3: SBocha (14210 in chips) 
Seat 5: giovannifut (12537 in chips) 
Seat 6: fecomunale (5075 in chips) 
Seat 7: kinnho007 (11249 in chips) 
Seat 8: GreenMohawk88 (9352 in chips) 
Seat 9: h_liminha (15563 in chips) 
FeGodines: posts the ante 15
flagao: posts the ante 15
SBocha: posts the ante 15
giovannifut: posts the ante 15
fecomunale: posts the ante 15
kinnho007: posts the ante 15
GreenMohawk88: posts the ante 15
h_liminha: posts the ante 15
kinnho007: posts small blind 60
GreenMohawk88: posts big blind 120
*** HOLE CARDS ***
Dealt to flagao [5d Jc]
h_liminha: folds 
FeGodines: raises 180 to 300
flagao: folds 
SBocha: folds 
giovannifut: folds 
fecomunale: calls 300
kinnho007: folds 
GreenMohawk88: calls 180
*** FLOP *** [5s 3c 7d]
GreenMohawk88: checks 
FeGodines: bets 346
fecomunale: calls 346
GreenMohawk88: folds 
*** TURN *** [5s 3c 7d] [Th]
FeGodines: bets 567
fecomunale: calls 567
*** RIVER *** [5s 3c 7d Th] [Kc]
FeGodines: checks 
fecomunale: checks 
*** SHOW DOWN ***
FeGodines: shows [2h Ah] (high card Ace)
fecomunale: shows [Ad 7c] (a pair of Sevens)
fecomunale collected 2906 from pot
*** SUMMARY ***
Total pot 2906 | Rake 0 
Board [5s 3c 7d Th Kc]
Seat 1: FeGodines showed [2h Ah] and lost with high card Ace
Seat 2: flagao folded before Flop (didn't bet)
Seat 3: SBocha folded before Flop (didn't bet)
Seat 5: giovannifut folded before Flop (didn't bet)
Seat 6: fecomunale (button) showed [Ad 7c] and won (2906) with a pair of Sevens
Seat 7: kinnho007 (small blind) folded before Flop
Seat 8: GreenMohawk88 (big blind) folded on the Flop
Seat 9: h_liminha folded before Flop (didn't bet)



PokerStars Home Game Hand #211089106334: {Club #3217684} Tournament #2845705715, 17000+3000 Hold'em No Limit - Level VIII (75/150) - 2020/03/31 21:52:25 ET
Table '2845705715 1' 9-max Seat #7 is the button
Seat 1: FeGodines (8427 in chips) 
Seat 2: flagao (7329 in chips) 
Seat 3: SBocha (14195 in chips) 
Seat 5: giovannifut (12522 in chips) 
Seat 6: fecomunale (6753 in chips) 
Seat 7: kinnho007 (11174 in chips) 
Seat 8: GreenMohawk88 (9037 in chips) 
Seat 9: h_liminha (15548 in chips) 
FeGodines: posts the ante 20
flagao: posts the ante 20
SBocha: posts the ante 20
giovannifut: posts the ante 20
fecomunale: posts the ante 20
kinnho007: posts the ante 20
GreenMohawk88: posts the ante 20
h_liminha: posts the ante 20
GreenMohawk88: posts small blind 75
h_liminha: posts big blind 150
*** HOLE CARDS ***
Dealt to flagao [Jc Js]
FeGodines: raises 225 to 375
flagao: calls 375
SBocha: folds 
giovannifut: folds 
fecomunale: folds 
kinnho007: calls 375
GreenMohawk88: folds 
h_liminha: calls 225
*** FLOP *** [2s Kd 2d]
h_liminha: checks 
FeGodines: checks 
flagao: checks 
kinnho007: bets 868
h_liminha: folds 
FeGodines: folds 
flagao: folds 
Uncalled bet (868) returned to kinnho007
kinnho007 collected 1735 from pot
kinnho007: doesn't show hand 
*** SUMMARY ***
Total pot 1735 | Rake 0 
Board [2s Kd 2d]
Seat 1: FeGodines folded on the Flop
Seat 2: flagao folded on the Flop
Seat 3: SBocha folded before Flop (didn't bet)
Seat 5: giovannifut folded before Flop (didn't bet)
Seat 6: fecomunale folded before Flop (didn't bet)
Seat 7: kinnho007 (button) collected (1735)
Seat 8: GreenMohawk88 (small blind) folded before Flop
Seat 9: h_liminha (big blind) folded on the Flop



PokerStars Home Game Hand #211089150441: {Club #3217684} Tournament #2845705715, 17000+3000 Hold'em No Limit - Level VIII (75/150) - 2020/03/31 21:53:27 ET
Table '2845705715 1' 9-max Seat #8 is the button
Seat 1: FeGodines (8032 in chips) 
Seat 2: flagao (6934 in chips) 
Seat 3: SBocha (14175 in chips) 
Seat 5: giovannifut (12502 in chips) 
Seat 6: fecomunale (6733 in chips) 
Seat 7: kinnho007 (12514 in chips) 
Seat 8: GreenMohawk88 (8942 in chips) 
Seat 9: h_liminha (15153 in chips) 
FeGodines: posts the ante 20
flagao: posts the ante 20
SBocha: posts the ante 20
giovannifut: posts the ante 20
fecomunale: posts the ante 20
kinnho007: posts the ante 20
GreenMohawk88: posts the ante 20
h_liminha: posts the ante 20
h_liminha: posts small blind 75
FeGodines: posts big blind 150
*** HOLE CARDS ***
Dealt to flagao [Jc 5c]
flagao: folds 
SBocha: calls 150
giovannifut: folds 
fecomunale: folds 
kinnho007: folds 
GreenMohawk88: calls 150
h_liminha: calls 75
FeGodines: checks 
*** FLOP *** [9h 6d 9c]
h_liminha: checks 
FeGodines: checks 
SBocha: checks 
GreenMohawk88: bets 450
GreenMohawk88 said, "=)"
h_liminha: folds 
FeGodines: folds 
SBocha: folds 
Uncalled bet (450) returned to GreenMohawk88
GreenMohawk88 collected 760 from pot
GreenMohawk88: doesn't show hand 
GreenMohawk88 said, "POXA"
*** SUMMARY ***
Total pot 760 | Rake 0 
Board [9h 6d 9c]
Seat 1: FeGodines (big blind) folded on the Flop
Seat 2: flagao folded before Flop (didn't bet)
Seat 3: SBocha folded on the Flop
Seat 5: giovannifut folded before Flop (didn't bet)
Seat 6: fecomunale folded before Flop (didn't bet)
Seat 7: kinnho007 folded before Flop (didn't bet)
Seat 8: GreenMohawk88 (button) collected (760)
Seat 9: h_liminha (small blind) folded on the Flop



PokerStars Home Game Hand #211089193442: {Club #3217684} Tournament #2845705715, 17000+3000 Hold'em No Limit - Level VIII (75/150) - 2020/03/31 21:54:42 ET
Table '2845705715 1' 9-max Seat #9 is the button
Seat 1: FeGodines (7862 in chips) 
Seat 2: flagao (6914 in chips) 
Seat 3: SBocha (14005 in chips) 
Seat 5: giovannifut (12482 in chips) 
Seat 6: fecomunale (6713 in chips) 
Seat 7: kinnho007 (12494 in chips) 
Seat 8: GreenMohawk88 (9532 in chips) 
Seat 9: h_liminha (14983 in chips) 
FeGodines: posts the ante 20
flagao: posts the ante 20
SBocha: posts the ante 20
giovannifut: posts the ante 20
fecomunale: posts the ante 20
kinnho007: posts the ante 20
GreenMohawk88: posts the ante 20
h_liminha: posts the ante 20
FeGodines: posts small blind 75
flagao: posts big blind 150
*** HOLE CARDS ***
Dealt to flagao [4d 5d]
SBocha: folds 
giovannifut: folds 
fecomunale: folds 
kinnho007: calls 150
GreenMohawk88: calls 150
h_liminha: calls 150
FeGodines: folds 
flagao: checks 
*** FLOP *** [Jh Ad Ks]
flagao: checks 
kinnho007: bets 418
GreenMohawk88: calls 418
h_liminha: folds 
flagao: folds 
*** TURN *** [Jh Ad Ks] [8h]
kinnho007: bets 836
GreenMohawk88: calls 836
*** RIVER *** [Jh Ad Ks 8h] [6h]
kinnho007: bets 1672
GreenMohawk88: folds 
Uncalled bet (1672) returned to kinnho007
kinnho007 collected 3343 from pot
kinnho007: doesn't show hand 
*** SUMMARY ***
Total pot 3343 | Rake 0 
Board [Jh Ad Ks 8h 6h]
Seat 1: FeGodines (small blind) folded before Flop
Seat 2: flagao (big blind) folded on the Flop
Seat 3: SBocha folded before Flop (didn't bet)
Seat 5: giovannifut folded before Flop (didn't bet)
Seat 6: fecomunale folded before Flop (didn't bet)
Seat 7: kinnho007 collected (3343)
Seat 8: GreenMohawk88 folded on the River
Seat 9: h_liminha (button) folded on the Flop



PokerStars Home Game Hand #211089388290: {Club #3217684} Tournament #2845705715, 17000+3000 Hold'em No Limit - Level VIII (75/150) - 2020/03/31 22:01:28 ET
Table '2845705715 1' 9-max Seat #1 is the button
Seat 1: FeGodines (7767 in chips) 
Seat 2: flagao (6744 in chips) 
Seat 3: SBocha (13985 in chips) 
Seat 5: giovannifut (12462 in chips) 
Seat 6: fecomunale (6693 in chips) 
Seat 7: kinnho007 (14413 in chips) 
Seat 8: GreenMohawk88 (8108 in chips) 
Seat 9: h_liminha (14813 in chips) 
FeGodines: posts the ante 20
flagao: posts the ante 20
SBocha: posts the ante 20
giovannifut: posts the ante 20
fecomunale: posts the ante 20
kinnho007: posts the ante 20
GreenMohawk88: posts the ante 20
h_liminha: posts the ante 20
flagao: posts small blind 75
SBocha: posts big blind 150
*** HOLE CARDS ***
Dealt to flagao [Kd Ts]
giovannifut: folds 
fecomunale: folds 
kinnho007: folds 
GreenMohawk88: calls 150
h_liminha: folds 
FeGodines: folds 
flagao: calls 75
SBocha: checks 
*** FLOP *** [Jd 2c 3s]
flagao: checks 
SBocha: checks 
GreenMohawk88: checks 
*** TURN *** [Jd 2c 3s] [Jh]
flagao: checks 
SBocha: checks 
GreenMohawk88: checks 
*** RIVER *** [Jd 2c 3s Jh] [6d]
flagao: checks 
SBocha: checks 
GreenMohawk88: checks 
*** SHOW DOWN ***
flagao: shows [Kd Ts] (a pair of Jacks)
SBocha: shows [Ac 8s] (a pair of Jacks - Ace kicker)
GreenMohawk88: mucks hand 
SBocha collected 610 from pot
*** SUMMARY ***
Total pot 610 | Rake 0 
Board [Jd 2c 3s Jh 6d]
Seat 1: FeGodines (button) folded before Flop (didn't bet)
Seat 2: flagao (small blind) showed [Kd Ts] and lost with a pair of Jacks
Seat 3: SBocha (big blind) showed [Ac 8s] and won (610) with a pair of Jacks
Seat 5: giovannifut folded before Flop (didn't bet)
Seat 6: fecomunale folded before Flop (didn't bet)
Seat 7: kinnho007 folded before Flop (didn't bet)
Seat 8: GreenMohawk88 mucked [5d Qd]
Seat 9: h_liminha folded before Flop (didn't bet)



PokerStars Home Game Hand #211089427167: {Club #3217684} Tournament #2845705715, 17000+3000 Hold'em No Limit - Level VIII (75/150) - 2020/03/31 22:02:37 ET
Table '2845705715 1' 9-max Seat #2 is the button
Seat 1: FeGodines (7747 in chips) 
Seat 2: flagao (6574 in chips) 
Seat 3: SBocha (14425 in chips) 
Seat 5: giovannifut (12442 in chips) 
Seat 6: fecomunale (6673 in chips) 
Seat 7: kinnho007 (14393 in chips) 
Seat 8: GreenMohawk88 (7938 in chips) 
Seat 9: h_liminha (14793 in chips) 
FeGodines: posts the ante 20
flagao: posts the ante 20
SBocha: posts the ante 20
giovannifut: posts the ante 20
fecomunale: posts the ante 20
kinnho007: posts the ante 20
GreenMohawk88: posts the ante 20
h_liminha: posts the ante 20
SBocha: posts small blind 75
giovannifut: posts big blind 150
*** HOLE CARDS ***
Dealt to flagao [3h 8c]
fecomunale: folds 
kinnho007: folds 
GreenMohawk88: folds 
h_liminha: folds 
FeGodines: raises 225 to 375
flagao: folds 
SBocha: calls 300
giovannifut: calls 225
*** FLOP *** [4d 7d Qd]
SBocha: checks 
giovannifut: checks 
FeGodines: bets 411
SBocha: raises 411 to 822
giovannifut: folds 
FeGodines: calls 411
*** TURN *** [4d 7d Qd] [4c]
SBocha: bets 1650
FeGodines: folds 
Uncalled bet (1650) returned to SBocha
SBocha collected 2929 from pot
SBocha: doesn't show hand 
*** SUMMARY ***
Total pot 2929 | Rake 0 
Board [4d 7d Qd 4c]
Seat 1: FeGodines folded on the Turn
Seat 2: flagao (button) folded before Flop (didn't bet)
Seat 3: SBocha (small blind) collected (2929)
Seat 5: giovannifut (big blind) folded on the Flop
Seat 6: fecomunale folded before Flop (didn't bet)
Seat 7: kinnho007 folded before Flop (didn't bet)
Seat 8: GreenMohawk88 folded before Flop (didn't bet)
Seat 9: h_liminha folded before Flop (didn't bet)



PokerStars Home Game Hand #211089477028: {Club #3217684} Tournament #2845705715, 17000+3000 Hold'em No Limit - Level VIII (75/150) - 2020/03/31 22:03:54 ET
Table '2845705715 1' 9-max Seat #3 is the button
Seat 1: FeGodines (6530 in chips) 
Seat 2: flagao (6554 in chips) 
Seat 3: SBocha (16137 in chips) 
Seat 5: giovannifut (12047 in chips) 
Seat 6: fecomunale (6653 in chips) 
Seat 7: kinnho007 (14373 in chips) 
Seat 8: GreenMohawk88 (7918 in chips) 
Seat 9: h_liminha (14773 in chips) 
FeGodines: posts the ante 20
flagao: posts the ante 20
SBocha: posts the ante 20
giovannifut: posts the ante 20
fecomunale: posts the ante 20
kinnho007: posts the ante 20
GreenMohawk88: posts the ante 20
h_liminha: posts the ante 20
giovannifut: posts small blind 75
fecomunale: posts big blind 150
*** HOLE CARDS ***
Dealt to flagao [Th 7c]
kinnho007: folds 
GreenMohawk88: folds 
h_liminha: folds 
FeGodines: folds 
flagao: folds 
SBocha: folds 
giovannifut: calls 75
fecomunale: checks 
*** FLOP *** [Ad Ks 3s]
giovannifut: checks 
fecomunale: checks 
*** TURN *** [Ad Ks 3s] [5h]
giovannifut: checks 
fecomunale: checks 
*** RIVER *** [Ad Ks 3s 5h] [8s]
giovannifut: bets 230
fecomunale: folds 
Uncalled bet (230) returned to giovannifut
giovannifut collected 460 from pot
giovannifut: doesn't show hand 
*** SUMMARY ***
Total pot 460 | Rake 0 
Board [Ad Ks 3s 5h 8s]
Seat 1: FeGodines folded before Flop (didn't bet)
Seat 2: flagao folded before Flop (didn't bet)
Seat 3: SBocha (button) folded before Flop (didn't bet)
Seat 5: giovannifut (small blind) collected (460)
Seat 6: fecomunale (big blind) folded on the River
Seat 7: kinnho007 folded before Flop (didn't bet)
Seat 8: GreenMohawk88 folded before Flop (didn't bet)
Seat 9: h_liminha folded before Flop (didn't bet)



PokerStars Home Game Hand #211089511821: {Club #3217684} Tournament #2845705715, 17000+3000 Hold'em No Limit - Level VIII (75/150) - 2020/03/31 22:04:56 ET
Table '2845705715 1' 9-max Seat #5 is the button
Seat 1: FeGodines (6510 in chips) 
Seat 2: flagao (6534 in chips) 
Seat 3: SBocha (16117 in chips) 
Seat 5: giovannifut (12337 in chips) 
Seat 6: fecomunale (6483 in chips) 
Seat 7: kinnho007 (14353 in chips) 
Seat 8: GreenMohawk88 (7898 in chips) 
Seat 9: h_liminha (14753 in chips) 
FeGodines: posts the ante 20
flagao: posts the ante 20
SBocha: posts the ante 20
giovannifut: posts the ante 20
fecomunale: posts the ante 20
kinnho007: posts the ante 20
GreenMohawk88: posts the ante 20
h_liminha: posts the ante 20
fecomunale: posts small blind 75
kinnho007: posts big blind 150
*** HOLE CARDS ***
Dealt to flagao [9d 8h]
GreenMohawk88: folds 
h_liminha: folds 
FeGodines: folds 
flagao: folds 
SBocha: folds 
giovannifut: calls 150
fecomunale: folds 
kinnho007: raises 150 to 300
giovannifut: calls 150
*** FLOP *** [2h 5d 8s]
kinnho007: bets 835
giovannifut: folds 
Uncalled bet (835) returned to kinnho007
kinnho007 collected 835 from pot
kinnho007: doesn't show hand 
*** SUMMARY ***
Total pot 835 | Rake 0 
Board [2h 5d 8s]
Seat 1: FeGodines folded before Flop (didn't bet)
Seat 2: flagao folded before Flop (didn't bet)
Seat 3: SBocha folded before Flop (didn't bet)
Seat 5: giovannifut (button) folded on the Flop
Seat 6: fecomunale (small blind) folded before Flop
Seat 7: kinnho007 (big blind) collected (835)
Seat 8: GreenMohawk88 folded before Flop (didn't bet)
Seat 9: h_liminha folded before Flop (didn't bet)



PokerStars Home Game Hand #211089546250: {Club #3217684} Tournament #2845705715, 17000+3000 Hold'em No Limit - Level VIII (75/150) - 2020/03/31 22:05:57 ET
Table '2845705715 1' 9-max Seat #6 is the button
Seat 1: FeGodines (6490 in chips) 
Seat 2: flagao (6514 in chips) 
Seat 3: SBocha (16097 in chips) 
Seat 5: giovannifut (12017 in chips) 
Seat 6: fecomunale (6388 in chips) 
Seat 7: kinnho007 (14868 in chips) 
Seat 8: GreenMohawk88 (7878 in chips) 
Seat 9: h_liminha (14733 in chips) 
FeGodines: posts the ante 20
flagao: posts the ante 20
SBocha: posts the ante 20
giovannifut: posts the ante 20
fecomunale: posts the ante 20
kinnho007: posts the ante 20
GreenMohawk88: posts the ante 20
h_liminha: posts the ante 20
kinnho007: posts small blind 75
GreenMohawk88: posts big blind 150
*** HOLE CARDS ***
Dealt to flagao [7h Jd]
h_liminha: folds 
FeGodines: raises 225 to 375
flagao: folds 
SBocha: folds 
giovannifut: folds 
fecomunale: folds 
kinnho007: folds 
GreenMohawk88: calls 225
*** FLOP *** [Ad 8c Qs]
GreenMohawk88: checks 
FeGodines: bets 315
GreenMohawk88: folds 
Uncalled bet (315) returned to FeGodines
FeGodines collected 985 from pot
FeGodines: doesn't show hand 
*** SUMMARY ***
Total pot 985 | Rake 0 
Board [Ad 8c Qs]
Seat 1: FeGodines collected (985)
Seat 2: flagao folded before Flop (didn't bet)
Seat 3: SBocha folded before Flop (didn't bet)
Seat 5: giovannifut folded before Flop (didn't bet)
Seat 6: fecomunale (button) folded before Flop (didn't bet)
Seat 7: kinnho007 (small blind) folded before Flop
Seat 8: GreenMohawk88 (big blind) folded on the Flop
Seat 9: h_liminha folded before Flop (didn't bet)



PokerStars Home Game Hand #211089570971: {Club #3217684} Tournament #2845705715, 17000+3000 Hold'em No Limit - Level VIII (75/150) - 2020/03/31 22:06:41 ET
Table '2845705715 1' 9-max Seat #7 is the button
Seat 1: FeGodines (7080 in chips) 
Seat 2: flagao (6494 in chips) 
Seat 3: SBocha (16077 in chips) 
Seat 5: giovannifut (11997 in chips) 
Seat 6: fecomunale (6368 in chips) 
Seat 7: kinnho007 (14773 in chips) 
Seat 8: GreenMohawk88 (7483 in chips) 
Seat 9: h_liminha (14713 in chips) 
FeGodines: posts the ante 20
flagao: posts the ante 20
SBocha: posts the ante 20
giovannifut: posts the ante 20
fecomunale: posts the ante 20
kinnho007: posts the ante 20
GreenMohawk88: posts the ante 20
h_liminha: posts the ante 20
GreenMohawk88: posts small blind 75
h_liminha: posts big blind 150
*** HOLE CARDS ***
Dealt to flagao [Js Kd]
FeGodines: folds 
flagao: raises 150 to 300
SBocha: folds 
giovannifut: folds 
fecomunale: calls 300
kinnho007: folds 
GreenMohawk88: folds 
h_liminha: calls 150
*** FLOP *** [6d Qc 5s]
h_liminha: checks 
flagao: checks 
fecomunale: checks 
*** TURN *** [6d Qc 5s] [7s]
h_liminha: checks 
flagao: bets 450
fecomunale: folds 
h_liminha: folds 
Uncalled bet (450) returned to flagao
flagao collected 1135 from pot
flagao: doesn't show hand 
*** SUMMARY ***
Total pot 1135 | Rake 0 
Board [6d Qc 5s 7s]
Seat 1: FeGodines folded before Flop (didn't bet)
Seat 2: flagao collected (1135)
Seat 3: SBocha folded before Flop (didn't bet)
Seat 5: giovannifut folded before Flop (didn't bet)
Seat 6: fecomunale folded on the Turn
Seat 7: kinnho007 (button) folded before Flop (didn't bet)
Seat 8: GreenMohawk88 (small blind) folded before Flop
Seat 9: h_liminha (big blind) folded on the Turn



PokerStars Home Game Hand #211089611474: {Club #3217684} Tournament #2845705715, 17000+3000 Hold'em No Limit - Level VIII (75/150) - 2020/03/31 22:07:54 ET
Table '2845705715 1' 9-max Seat #8 is the button
Seat 1: FeGodines (7060 in chips) 
Seat 2: flagao (7309 in chips) 
Seat 3: SBocha (16057 in chips) 
Seat 5: giovannifut (11977 in chips) 
Seat 6: fecomunale (6048 in chips) 
Seat 7: kinnho007 (14753 in chips) 
Seat 8: GreenMohawk88 (7388 in chips) 
Seat 9: h_liminha (14393 in chips) 
FeGodines: posts the ante 20
flagao: posts the ante 20
SBocha: posts the ante 20
giovannifut: posts the ante 20
fecomunale: posts the ante 20
kinnho007: posts the ante 20
GreenMohawk88: posts the ante 20
h_liminha: posts the ante 20
h_liminha: posts small blind 75
FeGodines: posts big blind 150
*** HOLE CARDS ***
Dealt to flagao [Jh 9c]
flagao: folds 
SBocha: folds 
giovannifut: folds 
fecomunale: folds 
kinnho007: folds 
GreenMohawk88: folds 
h_liminha: folds 
Uncalled bet (75) returned to FeGodines
FeGodines collected 310 from pot
FeGodines: doesn't show hand 
*** SUMMARY ***
Total pot 310 | Rake 0 
Seat 1: FeGodines (big blind) collected (310)
Seat 2: flagao folded before Flop (didn't bet)
Seat 3: SBocha folded before Flop (didn't bet)
Seat 5: giovannifut folded before Flop (didn't bet)
Seat 6: fecomunale folded before Flop (didn't bet)
Seat 7: kinnho007 folded before Flop (didn't bet)
Seat 8: GreenMohawk88 (button) folded before Flop (didn't bet)
Seat 9: h_liminha (small blind) folded before Flop



PokerStars Home Game Hand #211089626425: {Club #3217684} Tournament #2845705715, 17000+3000 Hold'em No Limit - Level IX (100/200) - 2020/03/31 22:08:21 ET
Table '2845705715 1' 9-max Seat #9 is the button
Seat 1: FeGodines (7275 in chips) 
Seat 2: flagao (7289 in chips) 
Seat 3: SBocha (16037 in chips) 
Seat 5: giovannifut (11957 in chips) 
Seat 6: fecomunale (6028 in chips) 
Seat 7: kinnho007 (14733 in chips) 
Seat 8: GreenMohawk88 (7368 in chips) 
Seat 9: h_liminha (14298 in chips) 
FeGodines: posts the ante 25
flagao: posts the ante 25
SBocha: posts the ante 25
giovannifut: posts the ante 25
fecomunale: posts the ante 25
kinnho007: posts the ante 25
GreenMohawk88: posts the ante 25
h_liminha: posts the ante 25
FeGodines: posts small blind 100
flagao: posts big blind 200
*** HOLE CARDS ***
Dealt to flagao [Ah 8c]
SBocha: folds 
giovannifut: folds 
fecomunale: folds 
kinnho007: folds 
GreenMohawk88: calls 200
h_liminha: calls 200
FeGodines: calls 100
flagao: checks 
*** FLOP *** [5c Jd 2s]
FeGodines: checks 
flagao: checks 
GreenMohawk88: checks 
h_liminha: bets 400
FeGodines: folds 
flagao: folds 
GreenMohawk88: folds 
Uncalled bet (400) returned to h_liminha
h_liminha collected 1000 from pot
GreenMohawk88 said, "t"
h_liminha: doesn't show hand 
*** SUMMARY ***
Total pot 1000 | Rake 0 
Board [5c Jd 2s]
Seat 1: FeGodines (small blind) folded on the Flop
Seat 2: flagao (big blind) folded on the Flop
Seat 3: SBocha folded before Flop (didn't bet)
Seat 5: giovannifut folded before Flop (didn't bet)
Seat 6: fecomunale folded before Flop (didn't bet)
Seat 7: kinnho007 folded before Flop (didn't bet)
Seat 8: GreenMohawk88 folded on the Flop
Seat 9: h_liminha (button) collected (1000)



PokerStars Home Game Hand #211089661920: {Club #3217684} Tournament #2845705715, 17000+3000 Hold'em No Limit - Level IX (100/200) - 2020/03/31 22:09:25 ET
Table '2845705715 1' 9-max Seat #1 is the button
Seat 1: FeGodines (7050 in chips) 
Seat 2: flagao (7064 in chips) 
Seat 3: SBocha (16012 in chips) 
Seat 5: giovannifut (11932 in chips) 
Seat 6: fecomunale (6003 in chips) 
Seat 7: kinnho007 (14708 in chips) 
Seat 8: GreenMohawk88 (7143 in chips) 
Seat 9: h_liminha (15073 in chips) 
FeGodines: posts the ante 25
flagao: posts the ante 25
SBocha: posts the ante 25
giovannifut: posts the ante 25
fecomunale: posts the ante 25
kinnho007: posts the ante 25
GreenMohawk88: posts the ante 25
h_liminha: posts the ante 25
flagao: posts small blind 100
SBocha: posts big blind 200
*** HOLE CARDS ***
Dealt to flagao [Ts Jd]
giovannifut: folds 
fecomunale: folds 
kinnho007: folds 
GreenMohawk88: calls 200
h_liminha: folds 
FeGodines: raises 600 to 800
flagao: folds 
SBocha: folds 
GreenMohawk88: calls 600
*** FLOP *** [8c 2s Ac]
GreenMohawk88: checks 
kinnho007 said, "quero rapazes roludos"
FeGodines: bets 672
GreenMohawk88: calls 672
*** TURN *** [8c 2s Ac] [Th]
GreenMohawk88: checks 
FeGodines: checks 
*** RIVER *** [8c 2s Ac Th] [Kc]
GreenMohawk88: checks 
FeGodines: checks 
*** SHOW DOWN ***
GreenMohawk88: shows [Ad 3s] (a pair of Aces)
FeGodines: shows [7h Ah] (a pair of Aces)
GreenMohawk88 collected 1722 from pot
FeGodines collected 1722 from pot
*** SUMMARY ***
Total pot 3444 | Rake 0 
Board [8c 2s Ac Th Kc]
Seat 1: FeGodines (button) showed [7h Ah] and won (1722) with a pair of Aces
Seat 2: flagao (small blind) folded before Flop
Seat 3: SBocha (big blind) folded before Flop
Seat 5: giovannifut folded before Flop (didn't bet)
Seat 6: fecomunale folded before Flop (didn't bet)
Seat 7: kinnho007 folded before Flop (didn't bet)
Seat 8: GreenMohawk88 showed [Ad 3s] and won (1722) with a pair of Aces
Seat 9: h_liminha folded before Flop (didn't bet)



PokerStars Home Game Hand #211089697242: {Club #3217684} Tournament #2845705715, 17000+3000 Hold'em No Limit - Level IX (100/200) - 2020/03/31 22:10:28 ET
Table '2845705715 1' 9-max Seat #2 is the button
Seat 1: FeGodines (7275 in chips) 
Seat 2: flagao (6939 in chips) 
Seat 3: SBocha (15787 in chips) 
Seat 5: giovannifut (11907 in chips) 
Seat 6: fecomunale (5978 in chips) 
Seat 7: kinnho007 (14683 in chips) 
Seat 8: GreenMohawk88 (7368 in chips) 
Seat 9: h_liminha (15048 in chips) 
FeGodines: posts the ante 25
flagao: posts the ante 25
SBocha: posts the ante 25
giovannifut: posts the ante 25
fecomunale: posts the ante 25
kinnho007: posts the ante 25
GreenMohawk88: posts the ante 25
h_liminha: posts the ante 25
SBocha: posts small blind 100
giovannifut: posts big blind 200
*** HOLE CARDS ***
Dealt to flagao [5s 6h]
fecomunale: raises 200 to 400
kinnho007: folds 
GreenMohawk88: calls 400
h_liminha: folds 
FeGodines: folds 
flagao: folds 
SBocha: folds 
giovannifut: calls 200
*** FLOP *** [As Jd 3s]
giovannifut: checks 
fecomunale: checks 
GreenMohawk88: checks 
*** TURN *** [As Jd 3s] [Qd]
giovannifut: bets 750
fecomunale: folds 
GreenMohawk88: calls 750
*** RIVER *** [As Jd 3s Qd] [Qs]
giovannifut: bets 3000
GreenMohawk88: calls 3000
*** SHOW DOWN ***
giovannifut: shows [Qc Kd] (three of a kind, Queens)
GreenMohawk88: shows [Kh Th] (a straight, Ten to Ace)
GreenMohawk88 collected 9000 from pot
*** SUMMARY ***
Total pot 9000 | Rake 0 
Board [As Jd 3s Qd Qs]
Seat 1: FeGodines folded before Flop (didn't bet)
Seat 2: flagao (button) folded before Flop (didn't bet)
Seat 3: SBocha (small blind) folded before Flop
Seat 5: giovannifut (big blind) showed [Qc Kd] and lost with three of a kind, Queens
Seat 6: fecomunale folded on the Turn
Seat 7: kinnho007 folded before Flop (didn't bet)
Seat 8: GreenMohawk88 showed [Kh Th] and won (9000) with a straight, Ten to Ace
Seat 9: h_liminha folded before Flop (didn't bet)



PokerStars Home Game Hand #211089751641: {Club #3217684} Tournament #2845705715, 17000+3000 Hold'em No Limit - Level IX (100/200) - 2020/03/31 22:11:58 ET
Table '2845705715 1' 9-max Seat #3 is the button
Seat 1: FeGodines (7250 in chips) 
Seat 2: flagao (6914 in chips) 
Seat 3: SBocha (15662 in chips) 
Seat 5: giovannifut (7732 in chips) 
Seat 6: fecomunale (5553 in chips) 
Seat 7: kinnho007 (14658 in chips) 
Seat 8: GreenMohawk88 (12193 in chips) 
Seat 9: h_liminha (15023 in chips) 
FeGodines: posts the ante 25
flagao: posts the ante 25
SBocha: posts the ante 25
giovannifut: posts the ante 25
fecomunale: posts the ante 25
kinnho007: posts the ante 25
GreenMohawk88: posts the ante 25
h_liminha: posts the ante 25
giovannifut: posts small blind 100
fecomunale: posts big blind 200
*** HOLE CARDS ***
Dealt to flagao [Kh 9h]
kinnho007: raises 700 to 900
GreenMohawk88 said, "fui bondoso, nem subi"
GreenMohawk88: folds 
h_liminha: folds 
FeGodines: folds 
flagao: folds 
SBocha: calls 900
giovannifut: folds 
fecomunale: folds 
*** FLOP *** [9d 5h 9s]
kinnho007: bets 2300
SBocha: folds 
Uncalled bet (2300) returned to kinnho007
kinnho007 collected 2300 from pot
kinnho007: doesn't show hand 
*** SUMMARY ***
Total pot 2300 | Rake 0 
Board [9d 5h 9s]
Seat 1: FeGodines folded before Flop (didn't bet)
Seat 2: flagao folded before Flop (didn't bet)
Seat 3: SBocha (button) folded on the Flop
Seat 5: giovannifut (small blind) folded before Flop
Seat 6: fecomunale (big blind) folded before Flop
Seat 7: kinnho007 collected (2300)
Seat 8: GreenMohawk88 folded before Flop (didn't bet)
Seat 9: h_liminha folded before Flop (didn't bet)



PokerStars Home Game Hand #211089779094: {Club #3217684} Tournament #2845705715, 17000+3000 Hold'em No Limit - Level IX (100/200) - 2020/03/31 22:12:48 ET
Table '2845705715 1' 9-max Seat #5 is the button
Seat 1: FeGodines (7225 in chips) 
Seat 2: flagao (6889 in chips) 
Seat 3: SBocha (14737 in chips) 
Seat 5: giovannifut (7607 in chips) 
Seat 6: fecomunale (5328 in chips) 
Seat 7: kinnho007 (16033 in chips) 
Seat 8: GreenMohawk88 (12168 in chips) 
Seat 9: h_liminha (14998 in chips) 
FeGodines: posts the ante 25
flagao: posts the ante 25
SBocha: posts the ante 25
giovannifut: posts the ante 25
fecomunale: posts the ante 25
kinnho007: posts the ante 25
GreenMohawk88: posts the ante 25
h_liminha: posts the ante 25
fecomunale: posts small blind 100
kinnho007: posts big blind 200
*** HOLE CARDS ***
Dealt to flagao [4h Ac]
GreenMohawk88: calls 200
h_liminha: folds 
FeGodines: folds 
flagao: folds 
SBocha: folds 
giovannifut: calls 200
fecomunale: folds 
kinnho007: raises 400 to 600
GreenMohawk88: calls 400
giovannifut: calls 400
*** FLOP *** [Th 9d Ks]
kinnho007: bets 1050
GreenMohawk88: calls 1050
giovannifut: folds 
*** TURN *** [Th 9d Ks] [2s]
kinnho007: checks 
GreenMohawk88: checks 
*** RIVER *** [Th 9d Ks 2s] [9c]
kinnho007: bets 1000
GreenMohawk88: calls 1000
*** SHOW DOWN ***
kinnho007: shows [5h 7h] (a pair of Nines)
GreenMohawk88: shows [As Kc] (two pair, Kings and Nines)
GreenMohawk88 collected 6200 from pot
*** SUMMARY ***
Total pot 6200 | Rake 0 
Board [Th 9d Ks 2s 9c]
Seat 1: FeGodines folded before Flop (didn't bet)
Seat 2: flagao folded before Flop (didn't bet)
Seat 3: SBocha folded before Flop (didn't bet)
Seat 5: giovannifut (button) folded on the Flop
Seat 6: fecomunale (small blind) folded before Flop
Seat 7: kinnho007 (big blind) showed [5h 7h] and lost with a pair of Nines
Seat 8: GreenMohawk88 showed [As Kc] and won (6200) with two pair, Kings and Nines
Seat 9: h_liminha folded before Flop (didn't bet)



PokerStars Home Game Hand #211089825668: {Club #3217684} Tournament #2845705715, 17000+3000 Hold'em No Limit - Level IX (100/200) - 2020/03/31 22:14:15 ET
Table '2845705715 1' 9-max Seat #6 is the button
Seat 1: FeGodines (7200 in chips) 
Seat 2: flagao (6864 in chips) 
Seat 3: SBocha (14712 in chips) 
Seat 5: giovannifut (6982 in chips) 
Seat 6: fecomunale (5203 in chips) 
Seat 7: kinnho007 (13358 in chips) 
Seat 9: h_liminha (14973 in chips) 
FeGodines: posts the ante 25
flagao: posts the ante 25
SBocha: posts the ante 25
giovannifut: posts the ante 25
fecomunale: posts the ante 25
kinnho007: posts the ante 25
h_liminha: posts the ante 25
kinnho007: posts small blind 100
h_liminha: posts big blind 200
*** HOLE CARDS ***
Dealt to flagao [2h Js]
FeGodines: folds 
flagao: folds 
SBocha: calls 200
giovannifut: calls 200
fecomunale: calls 200
kinnho007: calls 100
h_liminha: checks 
*** FLOP *** [8c Qc 7s]
kinnho007: checks 
h_liminha: checks 
SBocha: checks 
giovannifut: checks 
fecomunale: bets 588
kinnho007: folds 
h_liminha: folds 
SBocha: calls 588
giovannifut: calls 588
*** TURN *** [8c Qc 7s] [3d]
SBocha: checks 
giovannifut: checks 
fecomunale: bets 1470
SBocha: folds 
giovannifut: calls 1470
*** RIVER *** [8c Qc 7s 3d] [6h]
giovannifut: checks 
fecomunale: bets 2920 and is all-in
giovannifut: folds [Ac 4c]
Uncalled bet (2920) returned to fecomunale
fecomunale collected 5879 from pot
fecomunale: doesn't show hand 
*** SUMMARY ***
Total pot 5879 | Rake 0 
Board [8c Qc 7s 3d 6h]
Seat 1: FeGodines folded before Flop (didn't bet)
Seat 2: flagao folded before Flop (didn't bet)
Seat 3: SBocha folded on the Turn
Seat 5: giovannifut folded on the River
Seat 6: fecomunale (button) collected (5879)
Seat 7: kinnho007 (small blind) folded on the Flop
Seat 9: h_liminha (big blind) folded on the Flop



PokerStars Home Game Hand #211089879439: {Club #3217684} Tournament #2845705715, 17000+3000 Hold'em No Limit - Level IX (100/200) - 2020/03/31 22:15:49 ET
Table '2845705715 1' 9-max Seat #7 is the button
Seat 1: FeGodines (7175 in chips) 
Seat 2: flagao (6839 in chips) 
Seat 3: SBocha (13899 in chips) 
Seat 5: giovannifut (4699 in chips) 
Seat 6: fecomunale (8799 in chips) 
Seat 7: kinnho007 (13133 in chips) 
Seat 9: h_liminha (14748 in chips) 
FeGodines: posts the ante 25
flagao: posts the ante 25
SBocha: posts the ante 25
giovannifut: posts the ante 25
fecomunale: posts the ante 25
kinnho007: posts the ante 25
h_liminha: posts the ante 25
h_liminha: posts small blind 100
FeGodines: posts big blind 200
*** HOLE CARDS ***
Dealt to flagao [Th 7c]
flagao: folds 
SBocha: folds 
giovannifut: calls 200
fecomunale: raises 400 to 600
kinnho007: folds 
h_liminha: calls 500
FeGodines: calls 400
giovannifut: folds 
*** FLOP *** [5d Jd 9s]
h_liminha: checks 
FeGodines: bets 696
fecomunale: calls 696
h_liminha: calls 696
*** TURN *** [5d Jd 9s] [4d]
h_liminha: checks 
FeGodines: checks 
fecomunale: checks 
*** RIVER *** [5d Jd 9s 4d] [Td]
h_liminha: checks 
FeGodines: checks 
fecomunale: checks 
*** SHOW DOWN ***
h_liminha: shows [Tc 9c] (two pair, Tens and Nines)
FeGodines: shows [Js Qd] (a flush, Queen high)
fecomunale: mucks hand 
FeGodines collected 4263 from pot
*** SUMMARY ***
Total pot 4263 | Rake 0 
Board [5d Jd 9s 4d Td]
Seat 1: FeGodines (big blind) showed [Js Qd] and won (4263) with a flush, Queen high
Seat 2: flagao folded before Flop (didn't bet)
Seat 3: SBocha folded before Flop (didn't bet)
Seat 5: giovannifut folded before Flop
Seat 6: fecomunale mucked [Qh Qc]
Seat 7: kinnho007 (button) folded before Flop (didn't bet)
Seat 9: h_liminha (small blind) showed [Tc 9c] and lost with two pair, Tens and Nines



PokerStars Home Game Hand #211089917901: {Club #3217684} Tournament #2845705715, 17000+3000 Hold'em No Limit - Level IX (100/200) - 2020/03/31 22:17:00 ET
Table '2845705715 1' 9-max Seat #9 is the button
Seat 1: FeGodines (10117 in chips) 
Seat 2: flagao (6814 in chips) 
Seat 3: SBocha (13874 in chips) 
Seat 5: giovannifut (4474 in chips) 
Seat 6: fecomunale (7478 in chips) 
Seat 7: kinnho007 (13108 in chips) 
Seat 9: h_liminha (13427 in chips) 
FeGodines: posts the ante 25
flagao: posts the ante 25
SBocha: posts the ante 25
giovannifut: posts the ante 25
fecomunale: posts the ante 25
kinnho007: posts the ante 25
h_liminha: posts the ante 25
FeGodines: posts small blind 100
flagao: posts big blind 200
*** HOLE CARDS ***
Dealt to flagao [4d 6s]
SBocha: folds 
giovannifut: folds 
fecomunale: folds 
kinnho007: folds 
h_liminha: calls 200
FeGodines: folds 
flagao: checks 
*** FLOP *** [3h 3d As]
flagao: checks 
h_liminha: checks 
*** TURN *** [3h 3d As] [9h]
flagao: bets 400
h_liminha: folds 
Uncalled bet (400) returned to flagao
flagao collected 675 from pot
flagao: doesn't show hand 
*** SUMMARY ***
Total pot 675 | Rake 0 
Board [3h 3d As 9h]
Seat 1: FeGodines (small blind) folded before Flop
Seat 2: flagao (big blind) collected (675)
Seat 3: SBocha folded before Flop (didn't bet)
Seat 5: giovannifut folded before Flop (didn't bet)
Seat 6: fecomunale folded before Flop (didn't bet)
Seat 7: kinnho007 folded before Flop (didn't bet)
Seat 9: h_liminha (button) folded on the Turn



PokerStars Home Game Hand #211089942671: {Club #3217684} Tournament #2845705715, 17000+3000 Hold'em No Limit - Level IX (100/200) - 2020/03/31 22:17:43 ET
Table '2845705715 1' 9-max Seat #1 is the button
Seat 1: FeGodines (9992 in chips) 
Seat 2: flagao (7264 in chips) 
Seat 3: SBocha (13849 in chips) 
Seat 5: giovannifut (4449 in chips) 
Seat 6: fecomunale (7453 in chips) 
Seat 7: kinnho007 (13083 in chips) 
Seat 9: h_liminha (13202 in chips) 
FeGodines: posts the ante 25
flagao: posts the ante 25
SBocha: posts the ante 25
giovannifut: posts the ante 25
fecomunale: posts the ante 25
kinnho007: posts the ante 25
h_liminha: posts the ante 25
flagao: posts small blind 100
SBocha: posts big blind 200
*** HOLE CARDS ***
Dealt to flagao [Qh 2h]
giovannifut: raises 400 to 600
fecomunale: folds 
kinnho007: folds 
h_liminha: calls 600
FeGodines: folds 
flagao: folds 
SBocha: calls 400
*** FLOP *** [7c 7h 2s]
SBocha: checks 
giovannifut: checks 
h_liminha: checks 
*** TURN *** [7c 7h 2s] [9h]
SBocha: checks 
giovannifut: checks 
h_liminha: checks 
*** RIVER *** [7c 7h 2s 9h] [8s]
SBocha: checks 
giovannifut: checks 
h_liminha: checks 
*** SHOW DOWN ***
SBocha: shows [9c 6h] (two pair, Nines and Sevens)
giovannifut: mucks hand 
h_liminha: mucks hand 
SBocha collected 2075 from pot
*** SUMMARY ***
Total pot 2075 | Rake 0 
Board [7c 7h 2s 9h 8s]
Seat 1: FeGodines (button) folded before Flop (didn't bet)
Seat 2: flagao (small blind) folded before Flop
Seat 3: SBocha (big blind) showed [9c 6h] and won (2075) with two pair, Nines and Sevens
Seat 5: giovannifut mucked [Ah 4d]
Seat 6: fecomunale folded before Flop (didn't bet)
Seat 7: kinnho007 folded before Flop (didn't bet)
Seat 9: h_liminha mucked [Kc Jd]



PokerStars Home Game Hand #211089974881: {Club #3217684} Tournament #2845705715, 17000+3000 Hold'em No Limit - Level X (125/250) - 2020/03/31 22:18:44 ET
Table '2845705715 1' 9-max Seat #2 is the button
Seat 1: FeGodines (9967 in chips) 
Seat 2: flagao (7139 in chips) 
Seat 3: SBocha (15299 in chips) 
Seat 5: giovannifut (3824 in chips) 
Seat 6: fecomunale (7428 in chips) 
Seat 7: kinnho007 (13058 in chips) 
Seat 9: h_liminha (12577 in chips) 
FeGodines: posts the ante 30
flagao: posts the ante 30
SBocha: posts the ante 30
giovannifut: posts the ante 30
fecomunale: posts the ante 30
kinnho007: posts the ante 30
h_liminha: posts the ante 30
SBocha: posts small blind 125
giovannifut: posts big blind 250
*** HOLE CARDS ***
Dealt to flagao [Ad 3s]
fecomunale: folds 
kinnho007: folds 
h_liminha: raises 250 to 500
FeGodines: calls 500
flagao: folds 
SBocha: folds 
giovannifut: calls 250
*** FLOP *** [3c 2d 5s]
giovannifut: bets 1835
h_liminha: folds 
FeGodines: folds 
Uncalled bet (1835) returned to giovannifut
giovannifut collected 1835 from pot
giovannifut: doesn't show hand 
*** SUMMARY ***
Total pot 1835 | Rake 0 
Board [3c 2d 5s]
Seat 1: FeGodines folded on the Flop
Seat 2: flagao (button) folded before Flop (didn't bet)
Seat 3: SBocha (small blind) folded before Flop
Seat 5: giovannifut (big blind) collected (1835)
Seat 6: fecomunale folded before Flop (didn't bet)
Seat 7: kinnho007 folded before Flop (didn't bet)
Seat 9: h_liminha folded on the Flop



PokerStars Home Game Hand #211090009675: {Club #3217684} Tournament #2845705715, 17000+3000 Hold'em No Limit - Level X (125/250) - 2020/03/31 22:19:41 ET
Table '2845705715 1' 9-max Seat #3 is the button
Seat 1: FeGodines (9437 in chips) 
Seat 2: flagao (7109 in chips) 
Seat 3: SBocha (15144 in chips) 
Seat 5: giovannifut (5129 in chips) 
Seat 6: fecomunale (7398 in chips) 
Seat 7: kinnho007 (13028 in chips) 
Seat 9: h_liminha (12047 in chips) 
FeGodines: posts the ante 30
flagao: posts the ante 30
SBocha: posts the ante 30
giovannifut: posts the ante 30
fecomunale: posts the ante 30
kinnho007: posts the ante 30
h_liminha: posts the ante 30
giovannifut: posts small blind 125
fecomunale: posts big blind 250
*** HOLE CARDS ***
Dealt to flagao [Kh Ac]
kinnho007: folds 
h_liminha: calls 250
FeGodines: folds 
flagao: raises 500 to 750
SBocha: folds 
giovannifut: folds 
fecomunale: folds 
h_liminha: calls 500
*** FLOP *** [Ks Qs 2c]
h_liminha: checks 
flagao: bets 1000
h_liminha: calls 1000
*** TURN *** [Ks Qs 2c] [Qd]
h_liminha: checks 
flagao: bets 1250
h_liminha: calls 1250
*** RIVER *** [Ks Qs 2c Qd] [3s]
h_liminha: bets 1500
flagao: calls 1500
*** SHOW DOWN ***
h_liminha: shows [9h Kd] (two pair, Kings and Queens)
flagao: shows [Kh Ac] (two pair, Kings and Queens - Ace kicker)
flagao collected 9585 from pot
*** SUMMARY ***
Total pot 9585 | Rake 0 
Board [Ks Qs 2c Qd 3s]
Seat 1: FeGodines folded before Flop (didn't bet)
Seat 2: flagao showed [Kh Ac] and won (9585) with two pair, Kings and Queens
Seat 3: SBocha (button) folded before Flop (didn't bet)
Seat 5: giovannifut (small blind) folded before Flop
Seat 6: fecomunale (big blind) folded before Flop
Seat 7: kinnho007 folded before Flop (didn't bet)
Seat 9: h_liminha showed [9h Kd] and lost with two pair, Kings and Queens



PokerStars Home Game Hand #211090081008: {Club #3217684} Tournament #2845705715, 17000+3000 Hold'em No Limit - Level X (125/250) - 2020/03/31 22:21:41 ET
Table '2845705715 1' 9-max Seat #5 is the button
Seat 1: FeGodines (9407 in chips) 
Seat 2: flagao (12164 in chips) 
Seat 3: SBocha (15114 in chips) 
Seat 5: giovannifut (4974 in chips) 
Seat 6: fecomunale (7118 in chips) 
Seat 7: kinnho007 (12998 in chips) 
Seat 9: h_liminha (7517 in chips) 
FeGodines: posts the ante 30
flagao: posts the ante 30
SBocha: posts the ante 30
giovannifut: posts the ante 30
fecomunale: posts the ante 30
kinnho007: posts the ante 30
h_liminha: posts the ante 30
fecomunale: posts small blind 125
kinnho007: posts big blind 250
*** HOLE CARDS ***
Dealt to flagao [3d 5s]
h_liminha: folds 
FeGodines: raises 375 to 625
flagao: folds 
SBocha: folds 
giovannifut: folds 
fecomunale: folds 
kinnho007: folds 
Uncalled bet (375) returned to FeGodines
FeGodines collected 835 from pot
FeGodines: doesn't show hand 
*** SUMMARY ***
Total pot 835 | Rake 0 
Seat 1: FeGodines collected (835)
Seat 2: flagao folded before Flop (didn't bet)
Seat 3: SBocha folded before Flop (didn't bet)
Seat 5: giovannifut (button) folded before Flop (didn't bet)
Seat 6: fecomunale (small blind) folded before Flop
Seat 7: kinnho007 (big blind) folded before Flop
Seat 9: h_liminha folded before Flop (didn't bet)



PokerStars Home Game Hand #211090095090: {Club #3217684} Tournament #2845705715, 17000+3000 Hold'em No Limit - Level X (125/250) - 2020/03/31 22:22:08 ET
Table '2845705715 1' 9-max Seat #6 is the button
Seat 1: FeGodines (9962 in chips) 
Seat 2: flagao (12134 in chips) 
Seat 3: SBocha (15084 in chips) 
Seat 5: giovannifut (4944 in chips) 
Seat 6: fecomunale (6963 in chips) 
Seat 7: kinnho007 (12718 in chips) 
Seat 9: h_liminha (7487 in chips) 
FeGodines: posts the ante 30
flagao: posts the ante 30
SBocha: posts the ante 30
giovannifut: posts the ante 30
fecomunale: posts the ante 30
kinnho007: posts the ante 30
h_liminha: posts the ante 30
kinnho007: posts small blind 125
h_liminha: posts big blind 250
*** HOLE CARDS ***
Dealt to flagao [Qh 6s]
FeGodines: folds 
flagao: folds 
SBocha: folds 
giovannifut: raises 500 to 750
fecomunale: calls 750
kinnho007: folds 
h_liminha: calls 500
*** FLOP *** [7d 5d Jd]
h_liminha: bets 500
giovannifut: folds 
fecomunale: folds 
Uncalled bet (500) returned to h_liminha
h_liminha collected 2585 from pot
h_liminha: doesn't show hand 
*** SUMMARY ***
Total pot 2585 | Rake 0 
Board [7d 5d Jd]
Seat 1: FeGodines folded before Flop (didn't bet)
Seat 2: flagao folded before Flop (didn't bet)
Seat 3: SBocha folded before Flop (didn't bet)
Seat 5: giovannifut folded on the Flop
Seat 6: fecomunale (button) folded on the Flop
Seat 7: kinnho007 (small blind) folded before Flop
Seat 9: h_liminha (big blind) collected (2585)



PokerStars Home Game Hand #211090120817: {Club #3217684} Tournament #2845705715, 17000+3000 Hold'em No Limit - Level X (125/250) - 2020/03/31 22:22:56 ET
Table '2845705715 1' 9-max Seat #7 is the button
Seat 1: FeGodines (9932 in chips) 
Seat 2: flagao (12104 in chips) 
Seat 3: SBocha (15054 in chips) 
Seat 5: giovannifut (4164 in chips) 
Seat 6: fecomunale (6183 in chips) 
Seat 7: kinnho007 (12563 in chips) 
Seat 9: h_liminha (9292 in chips) 
FeGodines: posts the ante 30
flagao: posts the ante 30
SBocha: posts the ante 30
giovannifut: posts the ante 30
fecomunale: posts the ante 30
kinnho007: posts the ante 30
h_liminha: posts the ante 30
h_liminha: posts small blind 125
FeGodines: posts big blind 250
*** HOLE CARDS ***
Dealt to flagao [2h Jh]
flagao: folds 
SBocha: raises 250 to 500
giovannifut: calls 500
fecomunale: folds 
kinnho007: calls 500
h_liminha: folds 
FeGodines: calls 250
*** FLOP *** [Td Kh Ac]
FeGodines: checks 
SBocha: bets 1250
giovannifut: folds 
kinnho007: raises 1250 to 2500
FeGodines: folds 
SBocha: folds 
Uncalled bet (1250) returned to kinnho007
kinnho007 collected 4835 from pot
kinnho007: doesn't show hand 
*** SUMMARY ***
Total pot 4835 | Rake 0 
Board [Td Kh Ac]
Seat 1: FeGodines (big blind) folded on the Flop
Seat 2: flagao folded before Flop (didn't bet)
Seat 3: SBocha folded on the Flop
Seat 5: giovannifut folded on the Flop
Seat 6: fecomunale folded before Flop (didn't bet)
Seat 7: kinnho007 (button) collected (4835)
Seat 9: h_liminha (small blind) folded before Flop



PokerStars Home Game Hand #211090155457: {Club #3217684} Tournament #2845705715, 17000+3000 Hold'em No Limit - Level X (125/250) - 2020/03/31 22:24:01 ET
Table '2845705715 1' 9-max Seat #9 is the button
Seat 1: FeGodines (9402 in chips) 
Seat 2: flagao (12074 in chips) 
Seat 3: SBocha (13274 in chips) 
Seat 5: giovannifut (3634 in chips) 
Seat 6: fecomunale (6153 in chips) 
Seat 7: kinnho007 (15618 in chips) 
Seat 9: h_liminha (9137 in chips) 
FeGodines: posts the ante 30
flagao: posts the ante 30
SBocha: posts the ante 30
giovannifut: posts the ante 30
fecomunale: posts the ante 30
kinnho007: posts the ante 30
h_liminha: posts the ante 30
FeGodines: posts small blind 125
flagao: posts big blind 250
*** HOLE CARDS ***
Dealt to flagao [8c 8s]
SBocha: folds 
giovannifut: folds 
fecomunale: folds 
kinnho007: calls 250
h_liminha: calls 250
FeGodines: raises 1000 to 1250
flagao: calls 1000
kinnho007: folds 
h_liminha: calls 1000
*** FLOP *** [3h 3c 9c]
FeGodines: bets 1347
flagao: folds 
h_liminha: folds 
Uncalled bet (1347) returned to FeGodines
FeGodines collected 4210 from pot
FeGodines: doesn't show hand 
*** SUMMARY ***
Total pot 4210 | Rake 0 
Board [3h 3c 9c]
Seat 1: FeGodines (small blind) collected (4210)
Seat 2: flagao (big blind) folded on the Flop
Seat 3: SBocha folded before Flop (didn't bet)
Seat 5: giovannifut folded before Flop (didn't bet)
Seat 6: fecomunale folded before Flop (didn't bet)
Seat 7: kinnho007 folded before Flop
Seat 9: h_liminha (button) folded on the Flop



PokerStars Home Game Hand #211090195136: {Club #3217684} Tournament #2845705715, 17000+3000 Hold'em No Limit - Level X (125/250) - 2020/03/31 22:25:03 ET
Table '2845705715 1' 9-max Seat #1 is the button
Seat 1: FeGodines (12332 in chips) 
Seat 2: flagao (10794 in chips) 
Seat 3: SBocha (13244 in chips) 
Seat 5: giovannifut (3604 in chips) 
Seat 6: fecomunale (6123 in chips) 
Seat 7: kinnho007 (15338 in chips) 
Seat 9: h_liminha (7857 in chips) 
FeGodines: posts the ante 30
flagao: posts the ante 30
SBocha: posts the ante 30
giovannifut: posts the ante 30
fecomunale: posts the ante 30
kinnho007: posts the ante 30
h_liminha: posts the ante 30
flagao: posts small blind 125
SBocha: posts big blind 250
*** HOLE CARDS ***
Dealt to flagao [3h 7d]
giovannifut: raises 750 to 1000
fecomunale: folds 
kinnho007: folds 
h_liminha: calls 1000
FeGodines: folds 
flagao: folds 
SBocha: folds 
*** FLOP *** [Kh 2s 5h]
giovannifut: checks 
h_liminha: checks 
*** TURN *** [Kh 2s 5h] [8h]
giovannifut: bets 2574 and is all-in
h_liminha: folds 
Uncalled bet (2574) returned to giovannifut
giovannifut collected 2585 from pot
giovannifut: doesn't show hand 
*** SUMMARY ***
Total pot 2585 | Rake 0 
Board [Kh 2s 5h 8h]
Seat 1: FeGodines (button) folded before Flop (didn't bet)
Seat 2: flagao (small blind) folded before Flop
Seat 3: SBocha (big blind) folded before Flop
Seat 5: giovannifut collected (2585)
Seat 6: fecomunale folded before Flop (didn't bet)
Seat 7: kinnho007 folded before Flop (didn't bet)
Seat 9: h_liminha folded on the Turn



PokerStars Home Game Hand #211090214835: {Club #3217684} Tournament #2845705715, 17000+3000 Hold'em No Limit - Level X (125/250) - 2020/03/31 22:25:41 ET
Table '2845705715 1' 9-max Seat #2 is the button
Seat 1: FeGodines (12302 in chips) 
Seat 2: flagao (10639 in chips) 
Seat 3: SBocha (12964 in chips) 
Seat 5: giovannifut (5159 in chips) 
Seat 6: fecomunale (6093 in chips) 
Seat 7: kinnho007 (15308 in chips) 
Seat 9: h_liminha (6827 in chips) 
FeGodines: posts the ante 30
flagao: posts the ante 30
SBocha: posts the ante 30
giovannifut: posts the ante 30
fecomunale: posts the ante 30
kinnho007: posts the ante 30
h_liminha: posts the ante 30
SBocha: posts small blind 125
giovannifut: posts big blind 250
*** HOLE CARDS ***
Dealt to flagao [8c 3d]
fecomunale: folds 
kinnho007: folds 
h_liminha: calls 250
FeGodines: raises 750 to 1000
flagao: folds 
SBocha: folds 
giovannifut: folds 
h_liminha: folds 
Uncalled bet (750) returned to FeGodines
FeGodines collected 1085 from pot
FeGodines: doesn't show hand 
*** SUMMARY ***
Total pot 1085 | Rake 0 
Seat 1: FeGodines collected (1085)
Seat 2: flagao (button) folded before Flop (didn't bet)
Seat 3: SBocha (small blind) folded before Flop
Seat 5: giovannifut (big blind) folded before Flop
Seat 6: fecomunale folded before Flop (didn't bet)
Seat 7: kinnho007 folded before Flop (didn't bet)
Seat 9: h_liminha folded before Flop



PokerStars Home Game Hand #211090237722: {Club #3217684} Tournament #2845705715, 17000+3000 Hold'em No Limit - Level X (125/250) - 2020/03/31 22:26:25 ET
Table '2845705715 1' 9-max Seat #3 is the button
Seat 1: FeGodines (13107 in chips) 
Seat 2: flagao (10609 in chips) 
Seat 3: SBocha (12809 in chips) 
Seat 5: giovannifut (4879 in chips) 
Seat 6: fecomunale (6063 in chips) 
Seat 7: kinnho007 (15278 in chips) 
Seat 9: h_liminha (6547 in chips) 
FeGodines: posts the ante 30
flagao: posts the ante 30
SBocha: posts the ante 30
giovannifut: posts the ante 30
fecomunale: posts the ante 30
kinnho007: posts the ante 30
h_liminha: posts the ante 30
giovannifut: posts small blind 125
fecomunale: posts big blind 250
*** HOLE CARDS ***
Dealt to flagao [3s 7d]
kinnho007: folds 
h_liminha: calls 250
FeGodines: calls 250
flagao: folds 
SBocha: calls 250
giovannifut: calls 125
fecomunale: raises 250 to 500
h_liminha: calls 250
FeGodines: calls 250
SBocha: calls 250
giovannifut: calls 250
*** FLOP *** [5h Kc Ts]
giovannifut: checks 
fecomunale: bets 1355
h_liminha: calls 1355
FeGodines: folds 
SBocha: folds 
giovannifut: folds 
*** TURN *** [5h Kc Ts] [Jd]
fecomunale: bets 4178 and is all-in
h_liminha: folds 
Uncalled bet (4178) returned to fecomunale
fecomunale collected 5420 from pot
fecomunale: doesn't show hand 
*** SUMMARY ***
Total pot 5420 | Rake 0 
Board [5h Kc Ts Jd]
Seat 1: FeGodines folded on the Flop
Seat 2: flagao folded before Flop (didn't bet)
Seat 3: SBocha (button) folded on the Flop
Seat 5: giovannifut (small blind) folded on the Flop
Seat 6: fecomunale (big blind) collected (5420)
Seat 7: kinnho007 folded before Flop (didn't bet)
Seat 9: h_liminha folded on the Turn



PokerStars Home Game Hand #211090280193: {Club #3217684} Tournament #2845705715, 17000+3000 Hold'em No Limit - Level X (125/250) - 2020/03/31 22:27:46 ET
Table '2845705715 1' 9-max Seat #5 is the button
Seat 1: FeGodines (12577 in chips) 
Seat 2: flagao (10579 in chips) 
Seat 3: SBocha (12279 in chips) 
Seat 5: giovannifut (4349 in chips) 
Seat 6: fecomunale (9598 in chips) 
Seat 7: kinnho007 (15248 in chips) 
Seat 9: h_liminha (4662 in chips) 
FeGodines: posts the ante 30
flagao: posts the ante 30
SBocha: posts the ante 30
giovannifut: posts the ante 30
fecomunale: posts the ante 30
kinnho007: posts the ante 30
h_liminha: posts the ante 30
fecomunale: posts small blind 125
kinnho007: posts big blind 250
*** HOLE CARDS ***
Dealt to flagao [7d 3c]
h_liminha: folds 
FeGodines: folds 
flagao: folds 
SBocha: folds 
giovannifut: folds 
fecomunale: folds 
Uncalled bet (125) returned to kinnho007
kinnho007 collected 460 from pot
kinnho007: doesn't show hand 
*** SUMMARY ***
Total pot 460 | Rake 0 
Seat 1: FeGodines folded before Flop (didn't bet)
Seat 2: flagao folded before Flop (didn't bet)
Seat 3: SBocha folded before Flop (didn't bet)
Seat 5: giovannifut (button) folded before Flop (didn't bet)
Seat 6: fecomunale (small blind) folded before Flop
Seat 7: kinnho007 (big blind) collected (460)
Seat 9: h_liminha folded before Flop (didn't bet)



PokerStars Home Game Hand #211090288289: {Club #3217684} Tournament #2845705715, 17000+3000 Hold'em No Limit - Level X (125/250) - 2020/03/31 22:28:02 ET
Table '2845705715 1' 9-max Seat #6 is the button
Seat 1: FeGodines (12547 in chips) 
Seat 2: flagao (10549 in chips) 
Seat 3: SBocha (12249 in chips) 
Seat 5: giovannifut (4319 in chips) 
Seat 6: fecomunale (9443 in chips) 
Seat 7: kinnho007 (15553 in chips) 
Seat 9: h_liminha (4632 in chips) 
FeGodines: posts the ante 30
flagao: posts the ante 30
SBocha: posts the ante 30
giovannifut: posts the ante 30
fecomunale: posts the ante 30
kinnho007: posts the ante 30
h_liminha: posts the ante 30
kinnho007: posts small blind 125
h_liminha: posts big blind 250
*** HOLE CARDS ***
Dealt to flagao [5h 6c]
FeGodines: folds 
flagao: folds 
SBocha: folds 
giovannifut: folds 
fecomunale: folds 
kinnho007: raises 500 to 750
h_liminha: calls 500
*** FLOP *** [Th Qs Qd]
kinnho007: checks 
h_liminha: bets 1500
kinnho007: folds 
Uncalled bet (1500) returned to h_liminha
h_liminha collected 1710 from pot
h_liminha: doesn't show hand 
*** SUMMARY ***
Total pot 1710 | Rake 0 
Board [Th Qs Qd]
Seat 1: FeGodines folded before Flop (didn't bet)
Seat 2: flagao folded before Flop (didn't bet)
Seat 3: SBocha folded before Flop (didn't bet)
Seat 5: giovannifut folded before Flop (didn't bet)
Seat 6: fecomunale (button) folded before Flop (didn't bet)
Seat 7: kinnho007 (small blind) folded on the Flop
Seat 9: h_liminha (big blind) collected (1710)



PokerStars Home Game Hand #211090320389: {Club #3217684} Tournament #2845705715, 17000+3000 Hold'em No Limit - Level XI (150/300) - 2020/03/31 22:29:04 ET
Table '2845705715 1' 9-max Seat #7 is the button
Seat 1: FeGodines (12517 in chips) 
Seat 2: flagao (10519 in chips) 
Seat 3: SBocha (12219 in chips) 
Seat 5: giovannifut (4289 in chips) 
Seat 6: fecomunale (9413 in chips) 
Seat 7: kinnho007 (14773 in chips) 
Seat 9: h_liminha (5562 in chips) 
FeGodines: posts the ante 40
flagao: posts the ante 40
SBocha: posts the ante 40
giovannifut: posts the ante 40
fecomunale: posts the ante 40
kinnho007: posts the ante 40
h_liminha: posts the ante 40
h_liminha: posts small blind 150
FeGodines: posts big blind 300
*** HOLE CARDS ***
Dealt to flagao [Ks 3d]
flagao: folds 
SBocha: raises 600 to 900
giovannifut: folds 
fecomunale: folds 
kinnho007: folds 
h_liminha: folds 
FeGodines: folds 
Uncalled bet (600) returned to SBocha
SBocha collected 1030 from pot
SBocha: doesn't show hand 
*** SUMMARY ***
Total pot 1030 | Rake 0 
Seat 1: FeGodines (big blind) folded before Flop
Seat 2: flagao folded before Flop (didn't bet)
Seat 3: SBocha collected (1030)
Seat 5: giovannifut folded before Flop (didn't bet)
Seat 6: fecomunale folded before Flop (didn't bet)
Seat 7: kinnho007 (button) folded before Flop (didn't bet)
Seat 9: h_liminha (small blind) folded before Flop



PokerStars Home Game Hand #211090330973: {Club #3217684} Tournament #2845705715, 17000+3000 Hold'em No Limit - Level XI (150/300) - 2020/03/31 22:29:25 ET
Table '2845705715 1' 9-max Seat #9 is the button
Seat 1: FeGodines (12177 in chips) 
Seat 2: flagao (10479 in chips) 
Seat 3: SBocha (12909 in chips) 
Seat 5: giovannifut (4249 in chips) 
Seat 6: fecomunale (9373 in chips) 
Seat 7: kinnho007 (14733 in chips) 
Seat 9: h_liminha (5372 in chips) 
FeGodines: posts the ante 40
flagao: posts the ante 40
SBocha: posts the ante 40
giovannifut: posts the ante 40
fecomunale: posts the ante 40
kinnho007: posts the ante 40
h_liminha: posts the ante 40
FeGodines: posts small blind 150
flagao: posts big blind 300
*** HOLE CARDS ***
Dealt to flagao [Ah 7c]
SBocha: folds 
giovannifut: folds 
fecomunale: folds 
kinnho007: folds 
h_liminha: calls 300
FeGodines: folds 
flagao: checks 
*** FLOP *** [Ts Qc 7d]
flagao: bets 600
h_liminha: folds 
Uncalled bet (600) returned to flagao
flagao collected 1030 from pot
flagao: doesn't show hand 
*** SUMMARY ***
Total pot 1030 | Rake 0 
Board [Ts Qc 7d]
Seat 1: FeGodines (small blind) folded before Flop
Seat 2: flagao (big blind) collected (1030)
Seat 3: SBocha folded before Flop (didn't bet)
Seat 5: giovannifut folded before Flop (didn't bet)
Seat 6: fecomunale folded before Flop (didn't bet)
Seat 7: kinnho007 folded before Flop (didn't bet)
Seat 9: h_liminha (button) folded on the Flop



PokerStars Home Game Hand #211090356345: {Club #3217684} Tournament #2845705715, 17000+3000 Hold'em No Limit - Level XI (150/300) - 2020/03/31 22:30:13 ET
Table '2845705715 1' 9-max Seat #1 is the button
Seat 1: FeGodines (11987 in chips) 
Seat 2: flagao (11169 in chips) 
Seat 3: SBocha (12869 in chips) 
Seat 5: giovannifut (4209 in chips) 
Seat 6: fecomunale (9333 in chips) 
Seat 7: kinnho007 (14693 in chips) 
Seat 9: h_liminha (5032 in chips) 
FeGodines: posts the ante 40
flagao: posts the ante 40
SBocha: posts the ante 40
giovannifut: posts the ante 40
fecomunale: posts the ante 40
kinnho007: posts the ante 40
h_liminha: posts the ante 40
flagao: posts small blind 150
SBocha: posts big blind 300
*** HOLE CARDS ***
Dealt to flagao [Ad Kd]
giovannifut: calls 300
fecomunale: folds 
kinnho007: folds 
h_liminha: folds 
FeGodines: folds 
flagao: raises 300 to 600
SBocha: calls 300
giovannifut: calls 300
*** FLOP *** [9h 9s Qc]
flagao: bets 600
SBocha: folds 
giovannifut: raises 2969 to 3569 and is all-in
flagao: folds 
Uncalled bet (2969) returned to giovannifut
giovannifut collected 3280 from pot
giovannifut: doesn't show hand 
*** SUMMARY ***
Total pot 3280 | Rake 0 
Board [9h 9s Qc]
Seat 1: FeGodines (button) folded before Flop (didn't bet)
Seat 2: flagao (small blind) folded on the Flop
Seat 3: SBocha (big blind) folded on the Flop
Seat 5: giovannifut collected (3280)
Seat 6: fecomunale folded before Flop (didn't bet)
Seat 7: kinnho007 folded before Flop (didn't bet)
Seat 9: h_liminha folded before Flop (didn't bet)



PokerStars Home Game Hand #211090380153: {Club #3217684} Tournament #2845705715, 17000+3000 Hold'em No Limit - Level XI (150/300) - 2020/03/31 22:31:00 ET
Table '2845705715 1' 9-max Seat #2 is the button
Seat 1: FeGodines (11947 in chips) 
Seat 2: flagao (9929 in chips) 
Seat 3: SBocha (12229 in chips) 
Seat 5: giovannifut (6249 in chips) 
Seat 6: fecomunale (9293 in chips) 
Seat 7: kinnho007 (14653 in chips) 
Seat 9: h_liminha (4992 in chips) 
FeGodines: posts the ante 40
flagao: posts the ante 40
SBocha: posts the ante 40
giovannifut: posts the ante 40
fecomunale: posts the ante 40
kinnho007: posts the ante 40
h_liminha: posts the ante 40
SBocha: posts small blind 150
giovannifut: posts big blind 300
*** HOLE CARDS ***
Dealt to flagao [4s Kh]
fecomunale: folds 
kinnho007: folds 
h_liminha: folds 
FeGodines: folds 
flagao: folds 
SBocha: calls 150
giovannifut: checks 
*** FLOP *** [9h Tc 2d]
SBocha: checks 
giovannifut: checks 
*** TURN *** [9h Tc 2d] [2c]
SBocha: checks 
giovannifut: checks 
*** RIVER *** [9h Tc 2d 2c] [2s]
SBocha: checks 
giovannifut: checks 
*** SHOW DOWN ***
SBocha: shows [Qh 4c] (three of a kind, Deuces)
giovannifut: mucks hand 
SBocha collected 880 from pot
*** SUMMARY ***
Total pot 880 | Rake 0 
Board [9h Tc 2d 2c 2s]
Seat 1: FeGodines folded before Flop (didn't bet)
Seat 2: flagao (button) folded before Flop (didn't bet)
Seat 3: SBocha (small blind) showed [Qh 4c] and won (880) with three of a kind, Deuces
Seat 5: giovannifut (big blind) mucked [8d 7d]
Seat 6: fecomunale folded before Flop (didn't bet)
Seat 7: kinnho007 folded before Flop (didn't bet)
Seat 9: h_liminha folded before Flop (didn't bet)



PokerStars Home Game Hand #211090402931: {Club #3217684} Tournament #2845705715, 17000+3000 Hold'em No Limit - Level XI (150/300) - 2020/03/31 22:31:44 ET
Table '2845705715 1' 9-max Seat #3 is the button
Seat 1: FeGodines (11907 in chips) 
Seat 2: flagao (9889 in chips) 
Seat 3: SBocha (12769 in chips) 
Seat 5: giovannifut (5909 in chips) 
Seat 6: fecomunale (9253 in chips) 
Seat 7: kinnho007 (14613 in chips) 
Seat 9: h_liminha (4952 in chips) 
FeGodines: posts the ante 40
flagao: posts the ante 40
SBocha: posts the ante 40
giovannifut: posts the ante 40
fecomunale: posts the ante 40
kinnho007: posts the ante 40
h_liminha: posts the ante 40
giovannifut: posts small blind 150
fecomunale: posts big blind 300
*** HOLE CARDS ***
Dealt to flagao [6h 6c]
kinnho007: folds 
h_liminha: calls 300
FeGodines: folds 
flagao: raises 600 to 900
SBocha: folds 
giovannifut: folds 
fecomunale: folds 
h_liminha: calls 600
*** FLOP *** [Tc Kc Jh]
h_liminha: checks 
flagao: bets 900
h_liminha: calls 900
*** TURN *** [Tc Kc Jh] [As]
h_liminha: bets 1800
flagao: folds 
Uncalled bet (1800) returned to h_liminha
h_liminha collected 4330 from pot
h_liminha: doesn't show hand 
*** SUMMARY ***
Total pot 4330 | Rake 0 
Board [Tc Kc Jh As]
Seat 1: FeGodines folded before Flop (didn't bet)
Seat 2: flagao folded on the Turn
Seat 3: SBocha (button) folded before Flop (didn't bet)
Seat 5: giovannifut (small blind) folded before Flop
Seat 6: fecomunale (big blind) folded before Flop
Seat 7: kinnho007 folded before Flop (didn't bet)
Seat 9: h_liminha collected (4330)



PokerStars Home Game Hand #211090451745: {Club #3217684} Tournament #2845705715, 17000+3000 Hold'em No Limit - Level XI (150/300) - 2020/03/31 22:33:03 ET
Table '2845705715 1' 9-max Seat #5 is the button
Seat 1: FeGodines (11867 in chips) 
Seat 2: flagao (8049 in chips) 
Seat 3: SBocha (12729 in chips) 
Seat 5: giovannifut (5719 in chips) 
Seat 6: fecomunale (8913 in chips) 
Seat 7: kinnho007 (14573 in chips) 
Seat 9: h_liminha (7442 in chips) 
FeGodines: posts the ante 40
flagao: posts the ante 40
SBocha: posts the ante 40
giovannifut: posts the ante 40
fecomunale: posts the ante 40
kinnho007: posts the ante 40
h_liminha: posts the ante 40
fecomunale: posts small blind 150
kinnho007: posts big blind 300
*** HOLE CARDS ***
Dealt to flagao [3c 7s]
h_liminha: folds 
FeGodines: raises 360 to 660
flagao: folds 
SBocha: folds 
giovannifut: folds 
fecomunale: calls 510
kinnho007: calls 360
*** FLOP *** [Qd 5s Jc]
fecomunale: checks 
kinnho007: checks 
FeGodines: checks 
*** TURN *** [Qd 5s Jc] [8s]
fecomunale: checks 
kinnho007: bets 1130
FeGodines: calls 1130
fecomunale: folds 
*** RIVER *** [Qd 5s Jc 8s] [9s]
kinnho007: checks 
FeGodines: checks 
*** SHOW DOWN ***
kinnho007: shows [5d Ah] (a pair of Fives)
FeGodines: shows [Ad Jd] (a pair of Jacks)
FeGodines collected 4520 from pot
*** SUMMARY ***
Total pot 4520 | Rake 0 
Board [Qd 5s Jc 8s 9s]
Seat 1: FeGodines showed [Ad Jd] and won (4520) with a pair of Jacks
Seat 2: flagao folded before Flop (didn't bet)
Seat 3: SBocha folded before Flop (didn't bet)
Seat 5: giovannifut (button) folded before Flop (didn't bet)
Seat 6: fecomunale (small blind) folded on the Turn
Seat 7: kinnho007 (big blind) showed [5d Ah] and lost with a pair of Fives
Seat 9: h_liminha folded before Flop (didn't bet)



PokerStars Home Game Hand #211090491390: {Club #3217684} Tournament #2845705715, 17000+3000 Hold'em No Limit - Level XI (150/300) - 2020/03/31 22:34:21 ET
Table '2845705715 1' 9-max Seat #6 is the button
Seat 1: FeGodines (14557 in chips) 
Seat 2: flagao (8009 in chips) 
Seat 3: SBocha (12689 in chips) 
Seat 5: giovannifut (5679 in chips) 
Seat 6: fecomunale (8213 in chips) 
Seat 7: kinnho007 (12743 in chips) 
Seat 9: h_liminha (7402 in chips) 
FeGodines: posts the ante 40
flagao: posts the ante 40
SBocha: posts the ante 40
giovannifut: posts the ante 40
fecomunale: posts the ante 40
kinnho007: posts the ante 40
h_liminha: posts the ante 40
kinnho007: posts small blind 150
h_liminha: posts big blind 300
*** HOLE CARDS ***
Dealt to flagao [Ts 4c]
FeGodines: folds 
flagao: folds 
SBocha: folds 
giovannifut: folds 
fecomunale: folds 
kinnho007: calls 150
h_liminha: raises 600 to 900
kinnho007: calls 600
*** FLOP *** [Ah Kh 9s]
kinnho007: checks 
h_liminha: bets 2100
kinnho007: folds 
Uncalled bet (2100) returned to h_liminha
h_liminha collected 2080 from pot
h_liminha: doesn't show hand 
*** SUMMARY ***
Total pot 2080 | Rake 0 
Board [Ah Kh 9s]
Seat 1: FeGodines folded before Flop (didn't bet)
Seat 2: flagao folded before Flop (didn't bet)
Seat 3: SBocha folded before Flop (didn't bet)
Seat 5: giovannifut folded before Flop (didn't bet)
Seat 6: fecomunale (button) folded before Flop (didn't bet)
Seat 7: kinnho007 (small blind) folded on the Flop
Seat 9: h_liminha (big blind) collected (2080)



PokerStars Home Game Hand #211090525196: {Club #3217684} Tournament #2845705715, 17000+3000 Hold'em No Limit - Level XI (150/300) - 2020/03/31 22:35:27 ET
Table '2845705715 1' 9-max Seat #7 is the button
Seat 1: FeGodines (14517 in chips) 
Seat 2: flagao (7969 in chips) 
Seat 3: SBocha (12649 in chips) 
Seat 5: giovannifut (5639 in chips) 
Seat 6: fecomunale (8173 in chips) 
Seat 7: kinnho007 (11803 in chips) 
Seat 9: h_liminha (8542 in chips) 
FeGodines: posts the ante 40
flagao: posts the ante 40
SBocha: posts the ante 40
giovannifut: posts the ante 40
fecomunale: posts the ante 40
kinnho007: posts the ante 40
h_liminha: posts the ante 40
h_liminha: posts small blind 150
FeGodines: posts big blind 300
*** HOLE CARDS ***
Dealt to flagao [Ah 2d]
flagao: folds 
SBocha: calls 300
giovannifut: folds 
fecomunale: folds 
kinnho007: folds 
h_liminha: calls 150
FeGodines: raises 1200 to 1500
SBocha: calls 1200
h_liminha: folds 
*** FLOP *** [Ad 3d Kc]
FeGodines: checks 
SBocha: bets 1200
FeGodines: calls 1200
*** TURN *** [Ad 3d Kc] [Td]
FeGodines: checks 
SBocha: bets 3900
FeGodines: calls 3900
*** RIVER *** [Ad 3d Kc Td] [2s]
FeGodines: checks 
SBocha: checks 
*** SHOW DOWN ***
FeGodines: shows [Ac Kd] (two pair, Aces and Kings)
SBocha: shows [Jd Qd] (a flush, Ace high)
SBocha collected 13780 from pot
*** SUMMARY ***
Total pot 13780 | Rake 0 
Board [Ad 3d Kc Td 2s]
Seat 1: FeGodines (big blind) showed [Ac Kd] and lost with two pair, Aces and Kings
Seat 2: flagao folded before Flop (didn't bet)
Seat 3: SBocha showed [Jd Qd] and won (13780) with a flush, Ace high
Seat 5: giovannifut folded before Flop (didn't bet)
Seat 6: fecomunale folded before Flop (didn't bet)
Seat 7: kinnho007 (button) folded before Flop (didn't bet)
Seat 9: h_liminha (small blind) folded before Flop



PokerStars Home Game Hand #211090561879: {Club #3217684} Tournament #2845705715, 17000+3000 Hold'em No Limit - Level XI (150/300) - 2020/03/31 22:36:40 ET
Table '2845705715 1' 9-max Seat #9 is the button
Seat 1: FeGodines (7877 in chips) 
Seat 2: flagao (7929 in chips) 
Seat 3: SBocha (19789 in chips) 
Seat 5: giovannifut (5599 in chips) 
Seat 6: fecomunale (8133 in chips) 
Seat 7: kinnho007 (11763 in chips) 
Seat 9: h_liminha (8202 in chips) 
FeGodines: posts the ante 40
flagao: posts the ante 40
SBocha: posts the ante 40
giovannifut: posts the ante 40
fecomunale: posts the ante 40
kinnho007: posts the ante 40
h_liminha: posts the ante 40
FeGodines: posts small blind 150
flagao: posts big blind 300
*** HOLE CARDS ***
Dealt to flagao [7h Qs]
SBocha: folds 
giovannifut: raises 600 to 900
fecomunale: calls 900
kinnho007: folds 
h_liminha: folds 
FeGodines: folds 
flagao: folds 
*** FLOP *** [5d 2h 4h]
giovannifut: checks 
fecomunale: checks 
*** TURN *** [5d 2h 4h] [Ts]
giovannifut: bets 1265
fecomunale: folds 
Uncalled bet (1265) returned to giovannifut
giovannifut collected 2530 from pot
giovannifut: doesn't show hand 
*** SUMMARY ***
Total pot 2530 | Rake 0 
Board [5d 2h 4h Ts]
Seat 1: FeGodines (small blind) folded before Flop
Seat 2: flagao (big blind) folded before Flop
Seat 3: SBocha folded before Flop (didn't bet)
Seat 5: giovannifut collected (2530)
Seat 6: fecomunale folded on the Turn
Seat 7: kinnho007 folded before Flop (didn't bet)
Seat 9: h_liminha (button) folded before Flop (didn't bet)



PokerStars Home Game Hand #211090595540: {Club #3217684} Tournament #2845705715, 17000+3000 Hold'em No Limit - Level XI (150/300) - 2020/03/31 22:37:46 ET
Table '2845705715 1' 9-max Seat #1 is the button
Seat 1: FeGodines (7687 in chips) 
Seat 2: flagao (7589 in chips) 
Seat 3: SBocha (19749 in chips) 
Seat 5: giovannifut (7189 in chips) 
Seat 6: fecomunale (7193 in chips) 
Seat 7: kinnho007 (11723 in chips) 
Seat 9: h_liminha (8162 in chips) 
FeGodines: posts the ante 40
flagao: posts the ante 40
SBocha: posts the ante 40
giovannifut: posts the ante 40
fecomunale: posts the ante 40
kinnho007: posts the ante 40
h_liminha: posts the ante 40
flagao: posts small blind 150
SBocha: posts big blind 300
*** HOLE CARDS ***
Dealt to flagao [2h Qh]
giovannifut: folds 
fecomunale: calls 300
kinnho007: folds 
h_liminha: calls 300
FeGodines: folds 
flagao: calls 150
SBocha: checks 
*** FLOP *** [5d 9h 5s]
flagao: checks 
SBocha: checks 
fecomunale: checks 
h_liminha: checks 
*** TURN *** [5d 9h 5s] [3c]
flagao: checks 
SBocha: bets 300
fecomunale: folds 
h_liminha: folds 
flagao: calls 300
*** RIVER *** [5d 9h 5s 3c] [Ad]
flagao: bets 900
SBocha: folds 
Uncalled bet (900) returned to flagao
flagao collected 2080 from pot
flagao: doesn't show hand 
*** SUMMARY ***
Total pot 2080 | Rake 0 
Board [5d 9h 5s 3c Ad]
Seat 1: FeGodines (button) folded before Flop (didn't bet)
Seat 2: flagao (small blind) collected (2080)
Seat 3: SBocha (big blind) folded on the River
Seat 5: giovannifut folded before Flop (didn't bet)
Seat 6: fecomunale folded on the Turn
Seat 7: kinnho007 folded before Flop (didn't bet)
Seat 9: h_liminha folded on the Turn



PokerStars Home Game Hand #211090646126: {Club #3217684} Tournament #2845705715, 17000+3000 Hold'em No Limit - Level XII (200/400) - 2020/03/31 22:39:12 ET
Table '2845705715 1' 9-max Seat #2 is the button
Seat 1: FeGodines (7647 in chips) 
Seat 2: flagao (9029 in chips) 
Seat 3: SBocha (19109 in chips) 
Seat 5: giovannifut (7149 in chips) 
Seat 6: fecomunale (6853 in chips) 
Seat 7: kinnho007 (11683 in chips) 
Seat 9: h_liminha (7822 in chips) 
FeGodines: posts the ante 50
flagao: posts the ante 50
SBocha: posts the ante 50
giovannifut: posts the ante 50
fecomunale: posts the ante 50
kinnho007: posts the ante 50
h_liminha: posts the ante 50
SBocha: posts small blind 200
giovannifut: posts big blind 400
*** HOLE CARDS ***
Dealt to flagao [Ac Kd]
fecomunale: folds 
kinnho007: folds 
h_liminha: folds 
FeGodines: raises 480 to 880
flagao: raises 1120 to 2000
SBocha: folds 
giovannifut: folds 
FeGodines: folds 
Uncalled bet (1120) returned to flagao
flagao collected 2710 from pot
flagao: doesn't show hand 
*** SUMMARY ***
Total pot 2710 | Rake 0 
Seat 1: FeGodines folded before Flop
Seat 2: flagao (button) collected (2710)
Seat 3: SBocha (small blind) folded before Flop
Seat 5: giovannifut (big blind) folded before Flop
Seat 6: fecomunale folded before Flop (didn't bet)
Seat 7: kinnho007 folded before Flop (didn't bet)
Seat 9: h_liminha folded before Flop (didn't bet)



PokerStars Home Game Hand #211090663676: {Club #3217684} Tournament #2845705715, 17000+3000 Hold'em No Limit - Level XII (200/400) - 2020/03/31 22:39:47 ET
Table '2845705715 1' 9-max Seat #3 is the button
Seat 1: FeGodines (6717 in chips) 
Seat 2: flagao (10809 in chips) 
Seat 3: SBocha (18859 in chips) 
Seat 5: giovannifut (6699 in chips) 
Seat 6: fecomunale (6803 in chips) 
Seat 7: kinnho007 (11633 in chips) 
Seat 9: h_liminha (7772 in chips) 
FeGodines: posts the ante 50
flagao: posts the ante 50
SBocha: posts the ante 50
giovannifut: posts the ante 50
fecomunale: posts the ante 50
kinnho007: posts the ante 50
h_liminha: posts the ante 50
giovannifut: posts small blind 200
fecomunale: posts big blind 400
*** HOLE CARDS ***
Dealt to flagao [2h 5d]
kinnho007: folds 
h_liminha: folds 
FeGodines: raises 480 to 880
flagao: folds 
SBocha: folds 
giovannifut: calls 680
fecomunale: folds 
*** FLOP *** [7s Jc 6h]
giovannifut: checks 
FeGodines: bets 920
giovannifut: raises 4350 to 5270
FeGodines: folds 
Uncalled bet (4350) returned to giovannifut
giovannifut collected 4350 from pot
giovannifut: doesn't show hand 
*** SUMMARY ***
Total pot 4350 | Rake 0 
Board [7s Jc 6h]
Seat 1: FeGodines folded on the Flop
Seat 2: flagao folded before Flop (didn't bet)
Seat 3: SBocha (button) folded before Flop (didn't bet)
Seat 5: giovannifut (small blind) collected (4350)
Seat 6: fecomunale (big blind) folded before Flop
Seat 7: kinnho007 folded before Flop (didn't bet)
Seat 9: h_liminha folded before Flop (didn't bet)



PokerStars Home Game Hand #211090687734: {Club #3217684} Tournament #2845705715, 17000+3000 Hold'em No Limit - Level XII (200/400) - 2020/03/31 22:40:35 ET
Table '2845705715 1' 9-max Seat #5 is the button
Seat 1: FeGodines (4867 in chips) 
Seat 2: flagao (10759 in chips) 
Seat 3: SBocha (18809 in chips) 
Seat 5: giovannifut (9199 in chips) 
Seat 6: fecomunale (6353 in chips) 
Seat 7: kinnho007 (11583 in chips) 
Seat 9: h_liminha (7722 in chips) 
FeGodines: posts the ante 50
flagao: posts the ante 50
SBocha: posts the ante 50
giovannifut: posts the ante 50
fecomunale: posts the ante 50
kinnho007: posts the ante 50
h_liminha: posts the ante 50
fecomunale: posts small blind 200
kinnho007: posts big blind 400
*** HOLE CARDS ***
Dealt to flagao [Tc Kh]
h_liminha: folds 
FeGodines: folds 
flagao: raises 400 to 800
SBocha: raises 800 to 1600
giovannifut: folds 
fecomunale: folds 
kinnho007: folds 
flagao: calls 800
*** FLOP *** [Td 6s 4c]
flagao: bets 1200
SBocha: raises 2400 to 3600
flagao: folds 
Uncalled bet (2400) returned to SBocha
SBocha collected 6550 from pot
SBocha: doesn't show hand 
*** SUMMARY ***
Total pot 6550 | Rake 0 
Board [Td 6s 4c]
Seat 1: FeGodines folded before Flop (didn't bet)
Seat 2: flagao folded on the Flop
Seat 3: SBocha collected (6550)
Seat 5: giovannifut (button) folded before Flop (didn't bet)
Seat 6: fecomunale (small blind) folded before Flop
Seat 7: kinnho007 (big blind) folded before Flop
Seat 9: h_liminha folded before Flop (didn't bet)



PokerStars Home Game Hand #211090740393: {Club #3217684} Tournament #2845705715, 17000+3000 Hold'em No Limit - Level XII (200/400) - 2020/03/31 22:42:13 ET
Table '2845705715 1' 9-max Seat #6 is the button
Seat 1: FeGodines (4817 in chips) 
Seat 2: flagao (7909 in chips) 
Seat 3: SBocha (22509 in chips) 
Seat 5: giovannifut (9149 in chips) 
Seat 6: fecomunale (6103 in chips) 
Seat 7: kinnho007 (11133 in chips) 
Seat 9: h_liminha (7672 in chips) 
FeGodines: posts the ante 50
flagao: posts the ante 50
SBocha: posts the ante 50
giovannifut: posts the ante 50
fecomunale: posts the ante 50
kinnho007: posts the ante 50
h_liminha: posts the ante 50
kinnho007: posts small blind 200
h_liminha: posts big blind 400
*** HOLE CARDS ***
Dealt to flagao [7s 7h]
FeGodines: folds 
flagao: raises 400 to 800
SBocha: folds 
giovannifut: folds 
fecomunale: folds 
kinnho007: folds 
h_liminha: calls 400
*** FLOP *** [Qh 6s Qs]
h_liminha: checks 
flagao: bets 1200
h_liminha: raises 1200 to 2400
flagao: calls 1200
*** TURN *** [Qh 6s Qs] [Ac]
h_liminha: bets 4422 and is all-in
flagao: folds [7s 7h]
Uncalled bet (4422) returned to h_liminha
h_liminha collected 6950 from pot
h_liminha: doesn't show hand 
*** SUMMARY ***
Total pot 6950 | Rake 0 
Board [Qh 6s Qs Ac]
Seat 1: FeGodines folded before Flop (didn't bet)
Seat 2: flagao folded on the Turn
Seat 3: SBocha folded before Flop (didn't bet)
Seat 5: giovannifut folded before Flop (didn't bet)
Seat 6: fecomunale (button) folded before Flop (didn't bet)
Seat 7: kinnho007 (small blind) folded before Flop
Seat 9: h_liminha (big blind) collected (6950)



PokerStars Home Game Hand #211090784435: {Club #3217684} Tournament #2845705715, 17000+3000 Hold'em No Limit - Level XII (200/400) - 2020/03/31 22:43:44 ET
Table '2845705715 1' 9-max Seat #7 is the button
Seat 1: FeGodines (4767 in chips) 
Seat 2: flagao (4659 in chips) 
Seat 3: SBocha (22459 in chips) 
Seat 5: giovannifut (9099 in chips) 
Seat 6: fecomunale (6053 in chips) 
Seat 7: kinnho007 (10883 in chips) 
Seat 9: h_liminha (11372 in chips) 
FeGodines: posts the ante 50
flagao: posts the ante 50
SBocha: posts the ante 50
giovannifut: posts the ante 50
fecomunale: posts the ante 50
kinnho007: posts the ante 50
h_liminha: posts the ante 50
h_liminha: posts small blind 200
FeGodines: posts big blind 400
*** HOLE CARDS ***
Dealt to flagao [6s 8d]
flagao: folds 
SBocha: calls 400
giovannifut: folds 
fecomunale: folds 
kinnho007: folds 
h_liminha: calls 200
FeGodines: checks 
*** FLOP *** [Ks Js Tc]
h_liminha: checks 
FeGodines: checks 
SBocha: bets 800
h_liminha: folds 
FeGodines: folds 
Uncalled bet (800) returned to SBocha
SBocha collected 1550 from pot
SBocha: doesn't show hand 
*** SUMMARY ***
Total pot 1550 | Rake 0 
Board [Ks Js Tc]
Seat 1: FeGodines (big blind) folded on the Flop
Seat 2: flagao folded before Flop (didn't bet)
Seat 3: SBocha collected (1550)
Seat 5: giovannifut folded before Flop (didn't bet)
Seat 6: fecomunale folded before Flop (didn't bet)
Seat 7: kinnho007 (button) folded before Flop (didn't bet)
Seat 9: h_liminha (small blind) folded on the Flop



PokerStars Home Game Hand #211090806628: {Club #3217684} Tournament #2845705715, 17000+3000 Hold'em No Limit - Level XII (200/400) - 2020/03/31 22:44:29 ET
Table '2845705715 1' 9-max Seat #9 is the button
Seat 1: FeGodines (4317 in chips) 
Seat 2: flagao (4609 in chips) 
Seat 3: SBocha (23559 in chips) 
Seat 5: giovannifut (9049 in chips) 
Seat 6: fecomunale (6003 in chips) 
Seat 7: kinnho007 (10833 in chips) 
Seat 9: h_liminha (10922 in chips) 
FeGodines: posts the ante 50
flagao: posts the ante 50
SBocha: posts the ante 50
giovannifut: posts the ante 50
fecomunale: posts the ante 50
kinnho007: posts the ante 50
h_liminha: posts the ante 50
FeGodines: posts small blind 200
flagao: posts big blind 400
*** HOLE CARDS ***
Dealt to flagao [6c 9c]
SBocha: folds 
giovannifut: folds 
fecomunale: calls 400
kinnho007: folds 
h_liminha: folds 
FeGodines: folds 
flagao: checks 
*** FLOP *** [7d 4s 3d]
flagao: checks 
fecomunale: checks 
*** TURN *** [7d 4s 3d] [8s]
flagao: bets 800
fecomunale: calls 800
*** RIVER *** [7d 4s 3d 8s] [As]
flagao: bets 3359 and is all-in
fecomunale: folds 
Uncalled bet (3359) returned to flagao
flagao collected 2950 from pot
flagao: doesn't show hand 
*** SUMMARY ***
Total pot 2950 | Rake 0 
Board [7d 4s 3d 8s As]
Seat 1: FeGodines (small blind) folded before Flop
Seat 2: flagao (big blind) collected (2950)
Seat 3: SBocha folded before Flop (didn't bet)
Seat 5: giovannifut folded before Flop (didn't bet)
Seat 6: fecomunale folded on the River
Seat 7: kinnho007 folded before Flop (didn't bet)
Seat 9: h_liminha (button) folded before Flop (didn't bet)



PokerStars Home Game Hand #211090836834: {Club #3217684} Tournament #2845705715, 17000+3000 Hold'em No Limit - Level XII (200/400) - 2020/03/31 22:45:32 ET
Table '2845705715 1' 9-max Seat #1 is the button
Seat 1: FeGodines (4067 in chips) 
Seat 2: flagao (6309 in chips) 
Seat 3: SBocha (23509 in chips) 
Seat 5: giovannifut (8999 in chips) 
Seat 6: fecomunale (4753 in chips) 
Seat 7: kinnho007 (10783 in chips) 
Seat 9: h_liminha (10872 in chips) 
FeGodines: posts the ante 50
flagao: posts the ante 50
SBocha: posts the ante 50
giovannifut: posts the ante 50
fecomunale: posts the ante 50
kinnho007: posts the ante 50
h_liminha: posts the ante 50
flagao: posts small blind 200
SBocha: posts big blind 400
*** HOLE CARDS ***
Dealt to flagao [4h 2c]
giovannifut: folds 
fecomunale: folds 
kinnho007: raises 800 to 1200
h_liminha: calls 1200
FeGodines: folds 
flagao: folds 
SBocha: folds 
*** FLOP *** [3c Qd 4d]
kinnho007: bets 3350
h_liminha: folds 
Uncalled bet (3350) returned to kinnho007
kinnho007 collected 3350 from pot
kinnho007: doesn't show hand 
*** SUMMARY ***
Total pot 3350 | Rake 0 
Board [3c Qd 4d]
Seat 1: FeGodines (button) folded before Flop (didn't bet)
Seat 2: flagao (small blind) folded before Flop
Seat 3: SBocha (big blind) folded before Flop
Seat 5: giovannifut folded before Flop (didn't bet)
Seat 6: fecomunale folded before Flop (didn't bet)
Seat 7: kinnho007 collected (3350)
Seat 9: h_liminha folded on the Flop



PokerStars Home Game Hand #211090860553: {Club #3217684} Tournament #2845705715, 17000+3000 Hold'em No Limit - Level XII (200/400) - 2020/03/31 22:46:21 ET
Table '2845705715 1' 9-max Seat #2 is the button
Seat 1: FeGodines (4017 in chips) 
Seat 2: flagao (6059 in chips) 
Seat 3: SBocha (23059 in chips) 
Seat 5: giovannifut (8949 in chips) 
Seat 6: fecomunale (4703 in chips) 
Seat 7: kinnho007 (12883 in chips) 
Seat 9: h_liminha (9622 in chips) 
FeGodines: posts the ante 50
flagao: posts the ante 50
SBocha: posts the ante 50
giovannifut: posts the ante 50
fecomunale: posts the ante 50
kinnho007: posts the ante 50
h_liminha: posts the ante 50
SBocha: posts small blind 200
giovannifut: posts big blind 400
*** HOLE CARDS ***
Dealt to flagao [3s 6c]
fecomunale: folds 
kinnho007: folds 
h_liminha: folds 
FeGodines: raises 3567 to 3967 and is all-in
flagao: folds 
SBocha: folds 
giovannifut: folds 
Uncalled bet (3567) returned to FeGodines
FeGodines collected 1350 from pot
FeGodines: doesn't show hand 
*** SUMMARY ***
Total pot 1350 | Rake 0 
Seat 1: FeGodines collected (1350)
Seat 2: flagao (button) folded before Flop (didn't bet)
Seat 3: SBocha (small blind) folded before Flop
Seat 5: giovannifut (big blind) folded before Flop
Seat 6: fecomunale folded before Flop (didn't bet)
Seat 7: kinnho007 folded before Flop (didn't bet)
Seat 9: h_liminha folded before Flop (didn't bet)



PokerStars Home Game Hand #211090883662: {Club #3217684} Tournament #2845705715, 17000+3000 Hold'em No Limit - Level XII (200/400) - 2020/03/31 22:46:50 ET
Table '2845705715 1' 9-max Seat #3 is the button
Seat 1: FeGodines (4917 in chips) 
Seat 2: flagao (6009 in chips) 
Seat 3: SBocha (22809 in chips) 
Seat 5: giovannifut (8499 in chips) 
Seat 6: fecomunale (4653 in chips) 
Seat 7: kinnho007 (12833 in chips) 
Seat 9: h_liminha (9572 in chips) 
FeGodines: posts the ante 50
flagao: posts the ante 50
SBocha: posts the ante 50
giovannifut: posts the ante 50
fecomunale: posts the ante 50
kinnho007: posts the ante 50
h_liminha: posts the ante 50
giovannifut: posts small blind 200
fecomunale: posts big blind 400
*** HOLE CARDS ***
Dealt to flagao [4d Jc]
kinnho007: folds 
h_liminha: raises 400 to 800
FeGodines: folds 
flagao: folds 
SBocha: calls 800
giovannifut: folds 
fecomunale: folds 
*** FLOP *** [9c 8h Qd]
h_liminha: bets 1200
SBocha: calls 1200
*** TURN *** [9c 8h Qd] [3s]
h_liminha: bets 2000
SBocha: folds 
Uncalled bet (2000) returned to h_liminha
h_liminha collected 4950 from pot
h_liminha: doesn't show hand 
*** SUMMARY ***
Total pot 4950 | Rake 0 
Board [9c 8h Qd 3s]
Seat 1: FeGodines folded before Flop (didn't bet)
Seat 2: flagao folded before Flop (didn't bet)
Seat 3: SBocha (button) folded on the Turn
Seat 5: giovannifut (small blind) folded before Flop
Seat 6: fecomunale (big blind) folded before Flop
Seat 7: kinnho007 folded before Flop (didn't bet)
Seat 9: h_liminha collected (4950)



PokerStars Home Game Hand #211090917329: {Club #3217684} Tournament #2845705715, 17000+3000 Hold'em No Limit - Level XII (200/400) - 2020/03/31 22:48:00 ET
Table '2845705715 1' 9-max Seat #5 is the button
Seat 1: FeGodines (4867 in chips) 
Seat 2: flagao (5959 in chips) 
Seat 3: SBocha (20759 in chips) 
Seat 5: giovannifut (8249 in chips) 
Seat 6: fecomunale (4203 in chips) 
Seat 7: kinnho007 (12783 in chips) 
Seat 9: h_liminha (12472 in chips) 
FeGodines: posts the ante 50
flagao: posts the ante 50
SBocha: posts the ante 50
giovannifut: posts the ante 50
fecomunale: posts the ante 50
kinnho007: posts the ante 50
h_liminha: posts the ante 50
fecomunale: posts small blind 200
kinnho007: posts big blind 400
*** HOLE CARDS ***
Dealt to flagao [Ac 9s]
h_liminha: folds 
FeGodines: folds 
flagao: raises 400 to 800
SBocha: folds 
giovannifut: folds 
fecomunale: folds 
kinnho007: folds 
Uncalled bet (400) returned to flagao
flagao collected 1350 from pot
flagao: doesn't show hand 
*** SUMMARY ***
Total pot 1350 | Rake 0 
Seat 1: FeGodines folded before Flop (didn't bet)
Seat 2: flagao collected (1350)
Seat 3: SBocha folded before Flop (didn't bet)
Seat 5: giovannifut (button) folded before Flop (didn't bet)
Seat 6: fecomunale (small blind) folded before Flop
Seat 7: kinnho007 (big blind) folded before Flop
Seat 9: h_liminha folded before Flop (didn't bet)



PokerStars Home Game Hand #211090933800: {Club #3217684} Tournament #2845705715, 17000+3000 Hold'em No Limit - Level XIII (250/500) - 2020/03/31 22:48:34 ET
Table '2845705715 1' 9-max Seat #6 is the button
Seat 1: FeGodines (4817 in chips) 
Seat 2: flagao (6859 in chips) 
Seat 3: SBocha (20709 in chips) 
Seat 5: giovannifut (8199 in chips) 
Seat 6: fecomunale (3953 in chips) 
Seat 7: kinnho007 (12333 in chips) 
Seat 9: h_liminha (12422 in chips) 
FeGodines: posts the ante 60
flagao: posts the ante 60
SBocha: posts the ante 60
giovannifut: posts the ante 60
fecomunale: posts the ante 60
kinnho007: posts the ante 60
h_liminha: posts the ante 60
kinnho007: posts small blind 250
h_liminha: posts big blind 500
*** HOLE CARDS ***
Dealt to flagao [2c 9s]
FeGodines: raises 4257 to 4757 and is all-in
flagao: folds 
SBocha: folds 
giovannifut: folds 
fecomunale: folds 
kinnho007: folds 
h_liminha: folds 
Uncalled bet (4257) returned to FeGodines
FeGodines collected 1670 from pot
FeGodines: doesn't show hand 
*** SUMMARY ***
Total pot 1670 | Rake 0 
Seat 1: FeGodines collected (1670)
Seat 2: flagao folded before Flop (didn't bet)
Seat 3: SBocha folded before Flop (didn't bet)
Seat 5: giovannifut folded before Flop (didn't bet)
Seat 6: fecomunale (button) folded before Flop (didn't bet)
Seat 7: kinnho007 (small blind) folded before Flop
Seat 9: h_liminha (big blind) folded before Flop



PokerStars Home Game Hand #211090944326: {Club #3217684} Tournament #2845705715, 17000+3000 Hold'em No Limit - Level XIII (250/500) - 2020/03/31 22:48:56 ET
Table '2845705715 1' 9-max Seat #7 is the button
Seat 1: FeGodines (5927 in chips) 
Seat 2: flagao (6799 in chips) 
Seat 3: SBocha (20649 in chips) 
Seat 5: giovannifut (8139 in chips) 
Seat 6: fecomunale (3893 in chips) 
Seat 7: kinnho007 (12023 in chips) 
Seat 9: h_liminha (11862 in chips) 
FeGodines: posts the ante 60
flagao: posts the ante 60
SBocha: posts the ante 60
giovannifut: posts the ante 60
fecomunale: posts the ante 60
kinnho007: posts the ante 60
h_liminha: posts the ante 60
h_liminha: posts small blind 250
FeGodines: posts big blind 500
*** HOLE CARDS ***
Dealt to flagao [Th 7s]
flagao: folds 
SBocha: folds 
giovannifut: raises 500 to 1000
fecomunale: raises 2833 to 3833 and is all-in
kinnho007: folds 
h_liminha: folds 
FeGodines: folds 
giovannifut: folds 
Uncalled bet (2833) returned to fecomunale
fecomunale collected 3170 from pot
fecomunale: doesn't show hand 
*** SUMMARY ***
Total pot 3170 | Rake 0 
Seat 1: FeGodines (big blind) folded before Flop
Seat 2: flagao folded before Flop (didn't bet)
Seat 3: SBocha folded before Flop (didn't bet)
Seat 5: giovannifut folded before Flop
Seat 6: fecomunale collected (3170)
Seat 7: kinnho007 (button) folded before Flop (didn't bet)
Seat 9: h_liminha (small blind) folded before Flop



PokerStars Home Game Hand #211090966568: {Club #3217684} Tournament #2845705715, 17000+3000 Hold'em No Limit - Level XIII (250/500) - 2020/03/31 22:49:43 ET
Table '2845705715 1' 9-max Seat #9 is the button
Seat 1: FeGodines (5367 in chips) 
Seat 2: flagao (6739 in chips) 
Seat 3: SBocha (20589 in chips) 
Seat 5: giovannifut (7079 in chips) 
Seat 6: fecomunale (6003 in chips) 
Seat 7: kinnho007 (11963 in chips) 
Seat 9: h_liminha (11552 in chips) 
FeGodines: posts the ante 60
flagao: posts the ante 60
SBocha: posts the ante 60
giovannifut: posts the ante 60
fecomunale: posts the ante 60
kinnho007: posts the ante 60
h_liminha: posts the ante 60
FeGodines: posts small blind 250
flagao: posts big blind 500
*** HOLE CARDS ***
Dealt to flagao [6s 8c]
SBocha: folds 
giovannifut: folds 
fecomunale: folds 
kinnho007: folds 
h_liminha: folds 
FeGodines: folds 
Uncalled bet (250) returned to flagao
flagao collected 920 from pot
flagao: doesn't show hand 
*** SUMMARY ***
Total pot 920 | Rake 0 
Seat 1: FeGodines (small blind) folded before Flop
Seat 2: flagao (big blind) collected (920)
Seat 3: SBocha folded before Flop (didn't bet)
Seat 5: giovannifut folded before Flop (didn't bet)
Seat 6: fecomunale folded before Flop (didn't bet)
Seat 7: kinnho007 folded before Flop (didn't bet)
Seat 9: h_liminha (button) folded before Flop (didn't bet)



PokerStars Home Game Hand #211090977334: {Club #3217684} Tournament #2845705715, 17000+3000 Hold'em No Limit - Level XIII (250/500) - 2020/03/31 22:50:05 ET
Table '2845705715 1' 9-max Seat #1 is the button
Seat 1: FeGodines (5057 in chips) 
Seat 2: flagao (7349 in chips) 
Seat 3: SBocha (20529 in chips) 
Seat 5: giovannifut (7019 in chips) 
Seat 6: fecomunale (5943 in chips) 
Seat 7: kinnho007 (11903 in chips) 
Seat 9: h_liminha (11492 in chips) 
FeGodines: posts the ante 60
flagao: posts the ante 60
SBocha: posts the ante 60
giovannifut: posts the ante 60
fecomunale: posts the ante 60
kinnho007: posts the ante 60
h_liminha: posts the ante 60
flagao: posts small blind 250
SBocha: posts big blind 500
*** HOLE CARDS ***
Dealt to flagao [4s 2c]
giovannifut: raises 1000 to 1500
fecomunale: folds 
kinnho007: folds 
h_liminha: folds 
FeGodines: folds 
flagao: folds 
SBocha: calls 1000
*** FLOP *** [3s 8c Kh]
SBocha: checks 
giovannifut: checks 
*** TURN *** [3s 8c Kh] [3c]
SBocha: checks 
giovannifut: checks 
*** RIVER *** [3s 8c Kh 3c] [7d]
SBocha: checks 
giovannifut: checks 
*** SHOW DOWN ***
SBocha: shows [9h As] (a pair of Threes)
giovannifut: shows [Ah Qc] (a pair of Threes - Ace+King+Queen kicker)
giovannifut collected 3670 from pot
*** SUMMARY ***
Total pot 3670 | Rake 0 
Board [3s 8c Kh 3c 7d]
Seat 1: FeGodines (button) folded before Flop (didn't bet)
Seat 2: flagao (small blind) folded before Flop
Seat 3: SBocha (big blind) showed [9h As] and lost with a pair of Threes
Seat 5: giovannifut showed [Ah Qc] and won (3670) with a pair of Threes
Seat 6: fecomunale folded before Flop (didn't bet)
Seat 7: kinnho007 folded before Flop (didn't bet)
Seat 9: h_liminha folded before Flop (didn't bet)



PokerStars Home Game Hand #211091013189: {Club #3217684} Tournament #2845705715, 17000+3000 Hold'em No Limit - Level XIII (250/500) - 2020/03/31 22:51:21 ET
Table '2845705715 1' 9-max Seat #2 is the button
Seat 1: FeGodines (4997 in chips) 
Seat 2: flagao (7039 in chips) 
Seat 3: SBocha (18969 in chips) 
Seat 5: giovannifut (9129 in chips) 
Seat 6: fecomunale (5883 in chips) 
Seat 7: kinnho007 (11843 in chips) 
Seat 9: h_liminha (11432 in chips) 
FeGodines: posts the ante 60
flagao: posts the ante 60
SBocha: posts the ante 60
giovannifut: posts the ante 60
fecomunale: posts the ante 60
kinnho007: posts the ante 60
h_liminha: posts the ante 60
SBocha: posts small blind 250
giovannifut: posts big blind 500
*** HOLE CARDS ***
Dealt to flagao [As Ks]
fecomunale: folds 
kinnho007: folds 
h_liminha: folds 
FeGodines: folds 
flagao: raises 750 to 1250
SBocha: calls 1000
giovannifut: folds 
*** FLOP *** [7h Kc 4d]
SBocha: checks 
flagao: bets 1500
SBocha: folds 
Uncalled bet (1500) returned to flagao
flagao collected 3420 from pot
flagao: doesn't show hand 
*** SUMMARY ***
Total pot 3420 | Rake 0 
Board [7h Kc 4d]
Seat 1: FeGodines folded before Flop (didn't bet)
Seat 2: flagao (button) collected (3420)
Seat 3: SBocha (small blind) folded on the Flop
Seat 5: giovannifut (big blind) folded before Flop
Seat 6: fecomunale folded before Flop (didn't bet)
Seat 7: kinnho007 folded before Flop (didn't bet)
Seat 9: h_liminha folded before Flop (didn't bet)



PokerStars Home Game Hand #211091033404: {Club #3217684} Tournament #2845705715, 17000+3000 Hold'em No Limit - Level XIII (250/500) - 2020/03/31 22:52:03 ET
Table '2845705715 1' 9-max Seat #3 is the button
Seat 1: FeGodines (4937 in chips) 
Seat 2: flagao (9149 in chips) 
Seat 3: SBocha (17659 in chips) 
Seat 5: giovannifut (8569 in chips) 
Seat 6: fecomunale (5823 in chips) 
Seat 7: kinnho007 (11783 in chips) 
Seat 9: h_liminha (11372 in chips) 
FeGodines: posts the ante 60
flagao: posts the ante 60
SBocha: posts the ante 60
giovannifut: posts the ante 60
fecomunale: posts the ante 60
kinnho007: posts the ante 60
h_liminha: posts the ante 60
giovannifut: posts small blind 250
fecomunale: posts big blind 500
*** HOLE CARDS ***
Dealt to flagao [3c 9d]
kinnho007: folds 
h_liminha: calls 500
FeGodines: folds 
flagao: folds 
SBocha: raises 1000 to 1500
giovannifut: folds 
fecomunale: calls 1000
h_liminha: calls 1000
*** FLOP *** [4c Ac 8h]
fecomunale: checks 
h_liminha: checks 
SBocha: bets 2500
fecomunale: folds 
h_liminha: calls 2500
*** TURN *** [4c Ac 8h] [Kc]
h_liminha: bets 2500
SBocha: folds 
Uncalled bet (2500) returned to h_liminha
h_liminha collected 10170 from pot
*** SUMMARY ***
Total pot 10170 | Rake 0 
Board [4c Ac 8h Kc]
Seat 1: FeGodines folded before Flop (didn't bet)
Seat 2: flagao folded before Flop (didn't bet)
Seat 3: SBocha (button) folded on the Turn
Seat 5: giovannifut (small blind) folded before Flop
Seat 6: fecomunale (big blind) folded on the Flop
Seat 7: kinnho007 folded before Flop (didn't bet)
Seat 9: h_liminha collected (10170)



PokerStars Home Game Hand #211091062453: {Club #3217684} Tournament #2845705715, 17000+3000 Hold'em No Limit - Level XIII (250/500) - 2020/03/31 22:53:04 ET
Table '2845705715 1' 9-max Seat #5 is the button
Seat 1: FeGodines (4877 in chips) 
Seat 2: flagao (9089 in chips) 
Seat 3: SBocha (13599 in chips) 
Seat 5: giovannifut (8259 in chips) 
Seat 6: fecomunale (4263 in chips) 
Seat 7: kinnho007 (11723 in chips) 
Seat 9: h_liminha (17482 in chips) 
FeGodines: posts the ante 60
flagao: posts the ante 60
SBocha: posts the ante 60
giovannifut: posts the ante 60
fecomunale: posts the ante 60
kinnho007: posts the ante 60
h_liminha: posts the ante 60
fecomunale: posts small blind 250
kinnho007: posts big blind 500
*** HOLE CARDS ***
Dealt to flagao [Jh 9c]
h_liminha: folds 
FeGodines: raises 4317 to 4817 and is all-in
flagao: folds 
SBocha: folds 
giovannifut: folds 
fecomunale: folds 
kinnho007: folds 
Uncalled bet (4317) returned to FeGodines
FeGodines collected 1670 from pot
FeGodines: doesn't show hand 
*** SUMMARY ***
Total pot 1670 | Rake 0 
Seat 1: FeGodines collected (1670)
Seat 2: flagao folded before Flop (didn't bet)
Seat 3: SBocha folded before Flop (didn't bet)
Seat 5: giovannifut (button) folded before Flop (didn't bet)
Seat 6: fecomunale (small blind) folded before Flop
Seat 7: kinnho007 (big blind) folded before Flop
Seat 9: h_liminha folded before Flop (didn't bet)



PokerStars Home Game Hand #211091091276: {Club #3217684} Tournament #2845705715, 17000+3000 Hold'em No Limit - Level XIII (250/500) - 2020/03/31 22:54:05 ET
Table '2845705715 2' 9-max Seat #2 is the button
Seat 2: rafinha.nr (25855 in chips) 
Seat 3: LGPRENDES (19830 in chips) 
Seat 4: Junao TQSOP (5452 in chips) 
Seat 5: DinKinG 88 (17175 in chips) 
Seat 6: flagao (9029 in chips) 
Seat 7: beça07 (11688 in chips) 
rafinha.nr: posts the ante 60
LGPRENDES: posts the ante 60
Junao TQSOP: posts the ante 60
DinKinG 88: posts the ante 60
flagao: posts the ante 60
beça07: posts the ante 60
LGPRENDES: posts small blind 250
Junao TQSOP: posts big blind 500
*** HOLE CARDS ***
Dealt to flagao [Qs Ks]
DinKinG 88: calls 500
flagao: raises 750 to 1250
beça07: folds 
rafinha.nr: folds 
LGPRENDES: folds 
Junao TQSOP: folds 
DinKinG 88: calls 750
*** FLOP *** [Kc 4c 8h]
DinKinG 88: checks 
flagao: bets 1805
DinKinG 88: folds 
Uncalled bet (1805) returned to flagao
flagao collected 3610 from pot
flagao: doesn't show hand 
*** SUMMARY ***
Total pot 3610 | Rake 0 
Board [Kc 4c 8h]
Seat 2: rafinha.nr (button) folded before Flop (didn't bet)
Seat 3: LGPRENDES (small blind) folded before Flop
Seat 4: Junao TQSOP (big blind) folded before Flop
Seat 5: DinKinG 88 folded on the Flop
Seat 6: flagao collected (3610)
Seat 7: beça07 folded before Flop (didn't bet)



PokerStars Home Game Hand #211091116012: {Club #3217684} Tournament #2845705715, 17000+3000 Hold'em No Limit - Level XIII (250/500) - 2020/03/31 22:54:58 ET
Table '2845705715 2' 9-max Seat #3 is the button
Seat 1: FJara07 (17225 in chips) 
Seat 2: rafinha.nr (25795 in chips) 
Seat 3: LGPRENDES (19520 in chips) 
Seat 4: Junao TQSOP (4892 in chips) 
Seat 5: DinKinG 88 (15865 in chips) 
Seat 6: flagao (11329 in chips) 
Seat 7: beça07 (11628 in chips) 
Seat 8: JorgeCross5 (24477 in chips) 
Seat 9: @tico0503 (5733 in chips) 
FJara07: posts the ante 60
rafinha.nr: posts the ante 60
LGPRENDES: posts the ante 60
Junao TQSOP: posts the ante 60
DinKinG 88: posts the ante 60
flagao: posts the ante 60
beça07: posts the ante 60
JorgeCross5: posts the ante 60
@tico0503: posts the ante 60
Junao TQSOP: posts small blind 250
DinKinG 88: posts big blind 500
*** HOLE CARDS ***
Dealt to flagao [7d 3c]
flagao: folds 
beça07: calls 500
JorgeCross5: folds 
@tico0503: folds 
FJara07: calls 500
rafinha.nr: folds 
LGPRENDES is disconnected 
LGPRENDES has timed out while disconnected
LGPRENDES: folds 
Junao TQSOP: calls 250
DinKinG 88: checks 
*** FLOP *** [Jh 4d 4s]
Junao TQSOP: bets 1270
DinKinG 88: calls 1270
beça07: folds 
FJara07: folds 
*** TURN *** [Jh 4d 4s] [3s]
Junao TQSOP: checks 
DinKinG 88: checks 
*** RIVER *** [Jh 4d 4s 3s] [3h]
Junao TQSOP: checks 
DinKinG 88: checks 
*** SHOW DOWN ***
Junao TQSOP: shows [Js Qc] (two pair, Jacks and Fours)
DinKinG 88: shows [As Jc] (two pair, Jacks and Fours - Ace kicker)
DinKinG 88 collected 5080 from pot
*** SUMMARY ***
Total pot 5080 | Rake 0 
Board [Jh 4d 4s 3s 3h]
Seat 1: FJara07 folded on the Flop
Seat 2: rafinha.nr folded before Flop (didn't bet)
Seat 3: LGPRENDES (button) folded before Flop (didn't bet)
Seat 4: Junao TQSOP (small blind) showed [Js Qc] and lost with two pair, Jacks and Fours
Seat 5: DinKinG 88 (big blind) showed [As Jc] and won (5080) with two pair, Jacks and Fours
Seat 6: flagao folded before Flop (didn't bet)
Seat 7: beça07 folded on the Flop
Seat 8: JorgeCross5 folded before Flop (didn't bet)
Seat 9: @tico0503 folded before Flop (didn't bet)



PokerStars Home Game Hand #211091284335: {Club #3217684} Tournament #2845705715, 17000+3000 Hold'em No Limit - Level XIII (250/500) - 2020/03/31 23:01:31 ET
Table '2845705715 2' 9-max Seat #4 is the button
Seat 1: FJara07 (16665 in chips) 
Seat 2: rafinha.nr (25735 in chips) 
Seat 3: LGPRENDES (19460 in chips) 
Seat 4: Junao TQSOP (3062 in chips) 
Seat 5: DinKinG 88 (19115 in chips) 
Seat 6: flagao (11269 in chips) 
Seat 7: beça07 (11068 in chips) 
Seat 8: JorgeCross5 (24417 in chips) 
Seat 9: @tico0503 (5673 in chips) 
FJara07: posts the ante 60
rafinha.nr: posts the ante 60
LGPRENDES: posts the ante 60
Junao TQSOP: posts the ante 60
DinKinG 88: posts the ante 60
flagao: posts the ante 60
beça07: posts the ante 60
JorgeCross5: posts the ante 60
@tico0503: posts the ante 60
DinKinG 88: posts small blind 250
flagao: posts big blind 500
*** HOLE CARDS ***
Dealt to flagao [Ac 8c]
beça07: calls 500
JorgeCross5 has timed out
JorgeCross5: folds 
@tico0503: folds 
FJara07: folds 
rafinha.nr: calls 500
LGPRENDES: calls 500
Junao TQSOP: folds 
DinKinG 88: calls 250
flagao: checks 
*** FLOP *** [3h Th 7h]
DinKinG 88: checks 
flagao: checks 
beça07: checks 
rafinha.nr: bets 1300
LGPRENDES: folds 
DinKinG 88: folds 
flagao: folds 
beça07: folds 
Uncalled bet (1300) returned to rafinha.nr
rafinha.nr collected 3040 from pot
rafinha.nr: doesn't show hand 
*** SUMMARY ***
Total pot 3040 | Rake 0 
Board [3h Th 7h]
Seat 1: FJara07 folded before Flop (didn't bet)
Seat 2: rafinha.nr collected (3040)
Seat 3: LGPRENDES folded on the Flop
Seat 4: Junao TQSOP (button) folded before Flop (didn't bet)
Seat 5: DinKinG 88 (small blind) folded on the Flop
Seat 6: flagao (big blind) folded on the Flop
Seat 7: beça07 folded on the Flop
Seat 8: JorgeCross5 folded before Flop (didn't bet)
Seat 9: @tico0503 folded before Flop (didn't bet)



PokerStars Home Game Hand #211091361191: {Club #3217684} Tournament #2845705715, 17000+3000 Hold'em No Limit - Level XIII (250/500) - 2020/03/31 23:04:04 ET
Table '2845705715 2' 9-max Seat #5 is the button
Seat 1: FJara07 (16605 in chips) 
Seat 2: rafinha.nr (28215 in chips) 
Seat 3: LGPRENDES (18900 in chips) 
Seat 5: DinKinG 88 (18555 in chips) 
Seat 6: flagao (10709 in chips) 
Seat 7: beça07 (10508 in chips) 
Seat 8: JorgeCross5 (24357 in chips) is sitting out
Seat 9: @tico0503 (5613 in chips) 
FJara07: posts the ante 60
rafinha.nr: posts the ante 60
LGPRENDES: posts the ante 60
DinKinG 88: posts the ante 60
flagao: posts the ante 60
beça07: posts the ante 60
JorgeCross5: posts the ante 60
@tico0503: posts the ante 60
flagao: posts small blind 250
beça07: posts big blind 500
*** HOLE CARDS ***
Dealt to flagao [Tc Ks]
JorgeCross5: folds 
@tico0503: folds 
FJara07: folds 
rafinha.nr: folds 
LGPRENDES: folds 
DinKinG 88: folds 
flagao: raises 750 to 1250
beça07: calls 750
*** FLOP *** [Ts Jh 5h]
flagao: bets 1500
beça07: folds 
Uncalled bet (1500) returned to flagao
flagao collected 2980 from pot
flagao: doesn't show hand 
*** SUMMARY ***
Total pot 2980 | Rake 0 
Board [Ts Jh 5h]
Seat 1: FJara07 folded before Flop (didn't bet)
Seat 2: rafinha.nr folded before Flop (didn't bet)
Seat 3: LGPRENDES folded before Flop (didn't bet)
Seat 5: DinKinG 88 (button) folded before Flop (didn't bet)
Seat 6: flagao (small blind) collected (2980)
Seat 7: beça07 (big blind) folded on the Flop
Seat 8: JorgeCross5 folded before Flop (didn't bet)
Seat 9: @tico0503 folded before Flop (didn't bet)



PokerStars Home Game Hand #211091381099: {Club #3217684} Tournament #2845705715, 17000+3000 Hold'em No Limit - Level XIV (300/600) - 2020/03/31 23:04:47 ET
Table '2845705715 2' 9-max Seat #6 is the button
Seat 1: FJara07 (16545 in chips) 
Seat 2: rafinha.nr (28155 in chips) 
Seat 3: LGPRENDES (18840 in chips) 
Seat 5: DinKinG 88 (18495 in chips) 
Seat 6: flagao (12379 in chips) 
Seat 7: beça07 (9198 in chips) 
Seat 8: JorgeCross5 (24297 in chips) 
Seat 9: @tico0503 (5553 in chips) 
FJara07: posts the ante 70
rafinha.nr: posts the ante 70
LGPRENDES: posts the ante 70
DinKinG 88: posts the ante 70
flagao: posts the ante 70
beça07: posts the ante 70
JorgeCross5: posts the ante 70
@tico0503: posts the ante 70
beça07: posts small blind 300
JorgeCross5: posts big blind 600
*** HOLE CARDS ***
Dealt to flagao [8c 2h]
@tico0503: folds 
FJara07: folds 
rafinha.nr: folds 
LGPRENDES: folds 
DinKinG 88: calls 600
flagao: folds 
beça07: raises 8528 to 9128 and is all-in
JorgeCross5: folds 
DinKinG 88: folds 
Uncalled bet (8528) returned to beça07
beça07 collected 2360 from pot
beça07: doesn't show hand 
*** SUMMARY ***
Total pot 2360 | Rake 0 
Seat 1: FJara07 folded before Flop (didn't bet)
Seat 2: rafinha.nr folded before Flop (didn't bet)
Seat 3: LGPRENDES folded before Flop (didn't bet)
Seat 5: DinKinG 88 folded before Flop
Seat 6: flagao (button) folded before Flop (didn't bet)
Seat 7: beça07 (small blind) collected (2360)
Seat 8: JorgeCross5 (big blind) folded before Flop
Seat 9: @tico0503 folded before Flop (didn't bet)



PokerStars Home Game Hand #211091398514: {Club #3217684} Tournament #2845705715, 17000+3000 Hold'em No Limit - Level XIV (300/600) - 2020/03/31 23:05:25 ET
Table '2845705715 2' 9-max Seat #7 is the button
Seat 1: FJara07 (16475 in chips) 
Seat 2: rafinha.nr (28085 in chips) 
Seat 3: LGPRENDES (18770 in chips) 
Seat 5: DinKinG 88 (17825 in chips) 
Seat 6: flagao (12309 in chips) 
Seat 7: beça07 (10888 in chips) 
Seat 8: JorgeCross5 (23627 in chips) 
Seat 9: @tico0503 (5483 in chips) 
FJara07: posts the ante 70
rafinha.nr: posts the ante 70
LGPRENDES: posts the ante 70
DinKinG 88: posts the ante 70
flagao: posts the ante 70
beça07: posts the ante 70
JorgeCross5: posts the ante 70
@tico0503: posts the ante 70
JorgeCross5: posts small blind 300
@tico0503: posts big blind 600
*** HOLE CARDS ***
Dealt to flagao [Th Ks]
FJara07: folds 
rafinha.nr: raises 600 to 1200
LGPRENDES: folds 
DinKinG 88: folds 
flagao: calls 1200
beça07: folds 
JorgeCross5: folds 
@tico0503: calls 600
*** FLOP *** [2c 2d 6s]
@tico0503: checks 
rafinha.nr: checks 
flagao: checks 
*** TURN *** [2c 2d 6s] [6d]
rafinha.nr said, "1"
@tico0503: checks 
rafinha.nr: checks 
flagao: checks 
*** RIVER *** [2c 2d 6s 6d] [Qh]
@tico0503: checks 
rafinha.nr said, "meu microfone ta zuado"
rafinha.nr: bets 1200
flagao: folds 
@tico0503: folds 
Uncalled bet (1200) returned to rafinha.nr
rafinha.nr collected 4460 from pot
rafinha.nr: doesn't show hand 
*** SUMMARY ***
Total pot 4460 | Rake 0 
Board [2c 2d 6s 6d Qh]
Seat 1: FJara07 folded before Flop (didn't bet)
Seat 2: rafinha.nr collected (4460)
Seat 3: LGPRENDES folded before Flop (didn't bet)
Seat 5: DinKinG 88 folded before Flop (didn't bet)
Seat 6: flagao folded on the River
Seat 7: beça07 (button) folded before Flop (didn't bet)
Seat 8: JorgeCross5 (small blind) folded before Flop
Seat 9: @tico0503 (big blind) folded on the River



PokerStars Home Game Hand #211091431422: {Club #3217684} Tournament #2845705715, 17000+3000 Hold'em No Limit - Level XIV (300/600) - 2020/03/31 23:06:38 ET
Table '2845705715 2' 9-max Seat #8 is the button
Seat 1: FJara07 (16405 in chips) 
Seat 2: rafinha.nr (31275 in chips) 
Seat 3: LGPRENDES (18700 in chips) 
Seat 5: DinKinG 88 (17755 in chips) 
Seat 6: flagao (11039 in chips) 
Seat 7: beça07 (10818 in chips) 
Seat 8: JorgeCross5 (23257 in chips) 
Seat 9: @tico0503 (4213 in chips) 
FJara07: posts the ante 70
rafinha.nr: posts the ante 70
LGPRENDES: posts the ante 70
DinKinG 88: posts the ante 70
flagao: posts the ante 70
beça07: posts the ante 70
JorgeCross5: posts the ante 70
@tico0503: posts the ante 70
@tico0503: posts small blind 300
FJara07: posts big blind 600
*** HOLE CARDS ***
Dealt to flagao [Kc 2s]
rafinha.nr: folds 
LGPRENDES: folds 
DinKinG 88: folds 
flagao: folds 
beça07: folds 
JorgeCross5: folds 
@tico0503: calls 300
FJara07: raises 600 to 1200
@tico0503: folds 
Uncalled bet (600) returned to FJara07
FJara07 collected 1760 from pot
*** SUMMARY ***
Total pot 1760 | Rake 0 
Seat 1: FJara07 (big blind) collected (1760)
Seat 2: rafinha.nr folded before Flop (didn't bet)
Seat 3: LGPRENDES folded before Flop (didn't bet)
Seat 5: DinKinG 88 folded before Flop (didn't bet)
Seat 6: flagao folded before Flop (didn't bet)
Seat 7: beça07 folded before Flop (didn't bet)
Seat 8: JorgeCross5 (button) folded before Flop (didn't bet)
Seat 9: @tico0503 (small blind) folded before Flop



PokerStars Home Game Hand #211091444262: {Club #3217684} Tournament #2845705715, 17000+3000 Hold'em No Limit - Level XIV (300/600) - 2020/03/31 23:07:07 ET
Table '2845705715 2' 9-max Seat #9 is the button
Seat 1: FJara07 (17495 in chips) 
Seat 2: rafinha.nr (31205 in chips) 
Seat 3: LGPRENDES (18630 in chips) 
Seat 5: DinKinG 88 (17685 in chips) 
Seat 6: flagao (10969 in chips) 
Seat 7: beça07 (10748 in chips) 
Seat 8: JorgeCross5 (23187 in chips) 
Seat 9: @tico0503 (3543 in chips) 
FJara07: posts the ante 70
rafinha.nr: posts the ante 70
LGPRENDES: posts the ante 70
DinKinG 88: posts the ante 70
flagao: posts the ante 70
beça07: posts the ante 70
JorgeCross5: posts the ante 70
@tico0503: posts the ante 70
FJara07: posts small blind 300
rafinha.nr: posts big blind 600
*** HOLE CARDS ***
Dealt to flagao [Th Ac]
LGPRENDES: folds 
DinKinG 88: calls 600
flagao: raises 900 to 1500
beça07: folds 
JorgeCross5: folds 
@tico0503: folds 
FJara07: folds 
rafinha.nr: folds 
DinKinG 88: calls 900
*** FLOP *** [3d Tc 7d]
DinKinG 88: bets 1200
flagao: raises 1800 to 3000
DinKinG 88: calls 1800
*** TURN *** [3d Tc 7d] [As]
DinKinG 88: checks 
flagao: bets 1800
DinKinG 88: calls 1800
*** RIVER *** [3d Tc 7d As] [Qh]
DinKinG 88: checks 
flagao: bets 4599 and is all-in
DinKinG 88: calls 4599
*** SHOW DOWN ***
flagao: shows [Th Ac] (two pair, Aces and Tens)
DinKinG 88: shows [8d Qd] (a pair of Queens)
flagao collected 23258 from pot
*** SUMMARY ***
Total pot 23258 | Rake 0 
Board [3d Tc 7d As Qh]
Seat 1: FJara07 (small blind) folded before Flop
Seat 2: rafinha.nr (big blind) folded before Flop
Seat 3: LGPRENDES folded before Flop (didn't bet)
Seat 5: DinKinG 88 showed [8d Qd] and lost with a pair of Queens
Seat 6: flagao showed [Th Ac] and won (23258) with two pair, Aces and Tens
Seat 7: beça07 folded before Flop (didn't bet)
Seat 8: JorgeCross5 folded before Flop (didn't bet)
Seat 9: @tico0503 (button) folded before Flop (didn't bet)



PokerStars Home Game Hand #211091491846: {Club #3217684} Tournament #2845705715, 17000+3000 Hold'em No Limit - Level XIV (300/600) - 2020/03/31 23:08:53 ET
Table '2845705715 2' 9-max Seat #1 is the button
Seat 1: FJara07 (17125 in chips) 
Seat 2: rafinha.nr (30535 in chips) 
Seat 3: LGPRENDES (18560 in chips) 
Seat 5: DinKinG 88 (6716 in chips) 
Seat 6: flagao (23258 in chips) 
Seat 7: beça07 (10678 in chips) 
Seat 8: JorgeCross5 (23117 in chips) 
Seat 9: @tico0503 (3473 in chips) 
FJara07: posts the ante 70
rafinha.nr: posts the ante 70
LGPRENDES: posts the ante 70
DinKinG 88: posts the ante 70
flagao: posts the ante 70
beça07: posts the ante 70
JorgeCross5: posts the ante 70
@tico0503: posts the ante 70
rafinha.nr: posts small blind 300
LGPRENDES: posts big blind 600
*** HOLE CARDS ***
Dealt to flagao [Ks Js]
DinKinG 88: raises 6046 to 6646 and is all-in
flagao: folds 
beça07: folds 
JorgeCross5: folds 
@tico0503: folds 
FJara07: folds 
rafinha.nr: folds 
LGPRENDES: folds 
Uncalled bet (6046) returned to DinKinG 88
DinKinG 88 collected 2060 from pot
DinKinG 88: doesn't show hand 
*** SUMMARY ***
Total pot 2060 | Rake 0 
Seat 1: FJara07 (button) folded before Flop (didn't bet)
Seat 2: rafinha.nr (small blind) folded before Flop
Seat 3: LGPRENDES (big blind) folded before Flop
Seat 5: DinKinG 88 collected (2060)
Seat 6: flagao folded before Flop (didn't bet)
Seat 7: beça07 folded before Flop (didn't bet)
Seat 8: JorgeCross5 folded before Flop (didn't bet)
Seat 9: @tico0503 folded before Flop (didn't bet)



PokerStars Home Game Hand #211091509881: {Club #3217684} Tournament #2845705715, 17000+3000 Hold'em No Limit - Level XIV (300/600) - 2020/03/31 23:09:33 ET
Table '2845705715 2' 9-max Seat #2 is the button
Seat 1: FJara07 (17055 in chips) 
Seat 2: rafinha.nr (30165 in chips) 
Seat 3: LGPRENDES (17890 in chips) 
Seat 5: DinKinG 88 (8106 in chips) 
Seat 6: flagao (23188 in chips) 
Seat 7: beça07 (10608 in chips) 
Seat 8: JorgeCross5 (23047 in chips) 
Seat 9: @tico0503 (3403 in chips) 
FJara07: posts the ante 70
rafinha.nr: posts the ante 70
LGPRENDES: posts the ante 70
DinKinG 88: posts the ante 70
flagao: posts the ante 70
beça07: posts the ante 70
JorgeCross5: posts the ante 70
@tico0503: posts the ante 70
LGPRENDES: posts small blind 300
DinKinG 88: posts big blind 600
*** HOLE CARDS ***
Dealt to flagao [4h Jh]
flagao: folds 
beça07: folds 
JorgeCross5: folds 
@tico0503: folds 
FJara07: calls 600
rafinha.nr: calls 600
LGPRENDES: calls 300
DinKinG 88: checks 
*** FLOP *** [Jd 7c 6h]
LGPRENDES: checks 
DinKinG 88: checks 
FJara07: checks 
rafinha.nr: checks 
*** TURN *** [Jd 7c 6h] [9c]
LGPRENDES: checks 
DinKinG 88: checks 
FJara07: checks 
rafinha.nr: bets 1500
LGPRENDES: folds 
DinKinG 88: folds 
FJara07: folds 
Uncalled bet (1500) returned to rafinha.nr
rafinha.nr collected 2960 from pot
rafinha.nr: doesn't show hand 
*** SUMMARY ***
Total pot 2960 | Rake 0 
Board [Jd 7c 6h 9c]
Seat 1: FJara07 folded on the Turn
Seat 2: rafinha.nr (button) collected (2960)
Seat 3: LGPRENDES (small blind) folded on the Turn
Seat 5: DinKinG 88 (big blind) folded on the Turn
Seat 6: flagao folded before Flop (didn't bet)
Seat 7: beça07 folded before Flop (didn't bet)
Seat 8: JorgeCross5 folded before Flop (didn't bet)
Seat 9: @tico0503 folded before Flop (didn't bet)



PokerStars Home Game Hand #211091536186: {Club #3217684} Tournament #2845705715, 17000+3000 Hold'em No Limit - Level XIV (300/600) - 2020/03/31 23:10:32 ET
Table '2845705715 2' 9-max Seat #3 is the button
Seat 1: FJara07 (16385 in chips) 
Seat 2: rafinha.nr (32455 in chips) 
Seat 3: LGPRENDES (17220 in chips) 
Seat 5: DinKinG 88 (7436 in chips) 
Seat 6: flagao (23118 in chips) 
Seat 7: beça07 (10538 in chips) 
Seat 8: JorgeCross5 (22977 in chips) 
Seat 9: @tico0503 (3333 in chips) 
FJara07: posts the ante 70
rafinha.nr: posts the ante 70
LGPRENDES: posts the ante 70
DinKinG 88: posts the ante 70
flagao: posts the ante 70
beça07: posts the ante 70
JorgeCross5: posts the ante 70
@tico0503: posts the ante 70
DinKinG 88: posts small blind 300
flagao: posts big blind 600
*** HOLE CARDS ***
Dealt to flagao [8c 5c]
beça07: folds 
JorgeCross5: calls 600
@tico0503: folds 
FJara07: calls 600
rafinha.nr: folds 
LGPRENDES: calls 600
DinKinG 88: calls 300
flagao: checks 
*** FLOP *** [4c Ks 2d]
DinKinG 88: checks 
flagao: checks 
JorgeCross5: checks 
FJara07: bets 1800
LGPRENDES: folds 
DinKinG 88: folds 
flagao: folds 
JorgeCross5: folds 
Uncalled bet (1800) returned to FJara07
FJara07 collected 3560 from pot
FJara07: doesn't show hand 
*** SUMMARY ***
Total pot 3560 | Rake 0 
Board [4c Ks 2d]
Seat 1: FJara07 collected (3560)
Seat 2: rafinha.nr folded before Flop (didn't bet)
Seat 3: LGPRENDES (button) folded on the Flop
Seat 5: DinKinG 88 (small blind) folded on the Flop
Seat 6: flagao (big blind) folded on the Flop
Seat 7: beça07 folded before Flop (didn't bet)
Seat 8: JorgeCross5 folded on the Flop
Seat 9: @tico0503 folded before Flop (didn't bet)



PokerStars Home Game Hand #211091559707: {Club #3217684} Tournament #2845705715, 17000+3000 Hold'em No Limit - Level XIV (300/600) - 2020/03/31 23:11:24 ET
Table '2845705715 2' 9-max Seat #5 is the button
Seat 1: FJara07 (19275 in chips) 
Seat 2: rafinha.nr (32385 in chips) 
Seat 3: LGPRENDES (16550 in chips) 
Seat 5: DinKinG 88 (6766 in chips) 
Seat 6: flagao (22448 in chips) 
Seat 7: beça07 (10468 in chips) 
Seat 8: JorgeCross5 (22307 in chips) 
Seat 9: @tico0503 (3263 in chips) 
FJara07: posts the ante 70
rafinha.nr: posts the ante 70
LGPRENDES: posts the ante 70
DinKinG 88: posts the ante 70
flagao: posts the ante 70
beça07: posts the ante 70
JorgeCross5: posts the ante 70
@tico0503: posts the ante 70
flagao: posts small blind 300
beça07: posts big blind 600
*** HOLE CARDS ***
Dealt to flagao [3h 4c]
JorgeCross5: folds 
@tico0503: folds 
FJara07: folds 
rafinha.nr: calls 600
LGPRENDES: folds 
DinKinG 88: calls 600
flagao: folds 
beça07: checks 
*** FLOP *** [9s 6d Kh]
beça07: checks 
rafinha.nr: checks 
DinKinG 88: checks 
*** TURN *** [9s 6d Kh] [Qh]
beça07: checks 
rafinha.nr: checks 
DinKinG 88: bets 6000
beça07: folds 
rafinha.nr: folds 
Uncalled bet (6000) returned to DinKinG 88
DinKinG 88 collected 2660 from pot
DinKinG 88: doesn't show hand 
*** SUMMARY ***
Total pot 2660 | Rake 0 
Board [9s 6d Kh Qh]
Seat 1: FJara07 folded before Flop (didn't bet)
Seat 2: rafinha.nr folded on the Turn
Seat 3: LGPRENDES folded before Flop (didn't bet)
Seat 5: DinKinG 88 (button) collected (2660)
Seat 6: flagao (small blind) folded before Flop
Seat 7: beça07 (big blind) folded on the Turn
Seat 8: JorgeCross5 folded before Flop (didn't bet)
Seat 9: @tico0503 folded before Flop (didn't bet)



PokerStars Home Game Hand #211091583397: {Club #3217684} Tournament #2845705715, 17000+3000 Hold'em No Limit - Level XIV (300/600) - 2020/03/31 23:12:17 ET
Table '2845705715 2' 9-max Seat #6 is the button
Seat 1: FJara07 (19205 in chips) 
Seat 2: rafinha.nr (31715 in chips) 
Seat 3: LGPRENDES (16480 in chips) 
Seat 5: DinKinG 88 (8756 in chips) 
Seat 6: flagao (22078 in chips) 
Seat 7: beça07 (9798 in chips) 
Seat 8: JorgeCross5 (22237 in chips) 
Seat 9: @tico0503 (3193 in chips) 
FJara07: posts the ante 70
rafinha.nr: posts the ante 70
LGPRENDES: posts the ante 70
DinKinG 88: posts the ante 70
flagao: posts the ante 70
beça07: posts the ante 70
JorgeCross5: posts the ante 70
@tico0503: posts the ante 70
beça07: posts small blind 300
JorgeCross5: posts big blind 600
*** HOLE CARDS ***
Dealt to flagao [Jc 9s]
@tico0503: folds 
FJara07: folds 
rafinha.nr: folds 
LGPRENDES: raises 600 to 1200
DinKinG 88: folds 
flagao: folds 
beça07: folds 
JorgeCross5: calls 600
*** FLOP *** [9d 3s 3c]
JorgeCross5: checks 
LGPRENDES: bets 1800
JorgeCross5: folds 
Uncalled bet (1800) returned to LGPRENDES
LGPRENDES collected 3260 from pot
LGPRENDES: doesn't show hand 
*** SUMMARY ***
Total pot 3260 | Rake 0 
Board [9d 3s 3c]
Seat 1: FJara07 folded before Flop (didn't bet)
Seat 2: rafinha.nr folded before Flop (didn't bet)
Seat 3: LGPRENDES collected (3260)
Seat 5: DinKinG 88 folded before Flop (didn't bet)
Seat 6: flagao (button) folded before Flop (didn't bet)
Seat 7: beça07 (small blind) folded before Flop
Seat 8: JorgeCross5 (big blind) folded on the Flop
Seat 9: @tico0503 folded before Flop (didn't bet)



PokerStars Home Game Hand #211091621535: {Club #3217684} Tournament #2845705715, 17000+3000 Hold'em No Limit - Level XIV (300/600) - 2020/03/31 23:13:27 ET
Table '2845705715 2' 9-max Seat #7 is the button
Seat 1: FJara07 (19135 in chips) 
Seat 2: rafinha.nr (31645 in chips) 
Seat 3: LGPRENDES (18470 in chips) 
Seat 5: DinKinG 88 (8686 in chips) 
Seat 6: flagao (22008 in chips) 
Seat 7: beça07 (9428 in chips) 
Seat 8: JorgeCross5 (20967 in chips) 
Seat 9: @tico0503 (3123 in chips) 
FJara07: posts the ante 70
rafinha.nr: posts the ante 70
LGPRENDES: posts the ante 70
DinKinG 88: posts the ante 70
flagao: posts the ante 70
beça07: posts the ante 70
JorgeCross5: posts the ante 70
@tico0503: posts the ante 70
JorgeCross5: posts small blind 300
@tico0503: posts big blind 600
*** HOLE CARDS ***
Dealt to flagao [9h Th]
FJara07: folds 
rafinha.nr: folds 
LGPRENDES: calls 600
DinKinG 88: folds 
flagao: calls 600
beça07: folds 
JorgeCross5: folds 
@tico0503: checks 
*** FLOP *** [Kc 6c 6s]
@tico0503: checks 
LGPRENDES: bets 1800
flagao: folds 
@tico0503: folds 
Uncalled bet (1800) returned to LGPRENDES
LGPRENDES collected 2660 from pot
LGPRENDES: doesn't show hand 
*** SUMMARY ***
Total pot 2660 | Rake 0 
Board [Kc 6c 6s]
Seat 1: FJara07 folded before Flop (didn't bet)
Seat 2: rafinha.nr folded before Flop (didn't bet)
Seat 3: LGPRENDES collected (2660)
Seat 5: DinKinG 88 folded before Flop (didn't bet)
Seat 6: flagao folded on the Flop
Seat 7: beça07 (button) folded before Flop (didn't bet)
Seat 8: JorgeCross5 (small blind) folded before Flop
Seat 9: @tico0503 (big blind) folded on the Flop



PokerStars Home Game Hand #211091640414: {Club #3217684} Tournament #2845705715, 17000+3000 Hold'em No Limit - Level XIV (300/600) - 2020/03/31 23:14:10 ET
Table '2845705715 2' 9-max Seat #8 is the button
Seat 1: FJara07 (19065 in chips) 
Seat 2: rafinha.nr (31575 in chips) 
Seat 3: LGPRENDES (20460 in chips) 
Seat 5: DinKinG 88 (8616 in chips) 
Seat 6: flagao (21338 in chips) 
Seat 7: beça07 (9358 in chips) 
Seat 8: JorgeCross5 (20597 in chips) 
Seat 9: @tico0503 (2453 in chips) 
FJara07: posts the ante 70
rafinha.nr: posts the ante 70
LGPRENDES: posts the ante 70
DinKinG 88: posts the ante 70
flagao: posts the ante 70
beça07: posts the ante 70
JorgeCross5: posts the ante 70
@tico0503: posts the ante 70
@tico0503: posts small blind 300
FJara07: posts big blind 600
*** HOLE CARDS ***
Dealt to flagao [2h Ks]
rafinha.nr: folds 
LGPRENDES: calls 600
DinKinG 88: folds 
flagao: folds 
beça07: folds 
JorgeCross5: folds 
@tico0503: raises 1783 to 2383 and is all-in
FJara07: folds 
LGPRENDES: calls 1783
*** FLOP *** [5s Kd 4c]
*** TURN *** [5s Kd 4c] [Ts]
*** RIVER *** [5s Kd 4c Ts] [6d]
*** SHOW DOWN ***
@tico0503: shows [7s 7d] (a pair of Sevens)
LGPRENDES: shows [6s Ac] (a pair of Sixes)
@tico0503 collected 5926 from pot
*** SUMMARY ***
Total pot 5926 | Rake 0 
Board [5s Kd 4c Ts 6d]
Seat 1: FJara07 (big blind) folded before Flop
Seat 2: rafinha.nr folded before Flop (didn't bet)
Seat 3: LGPRENDES showed [6s Ac] and lost with a pair of Sixes
Seat 5: DinKinG 88 folded before Flop (didn't bet)
Seat 6: flagao folded before Flop (didn't bet)
Seat 7: beça07 folded before Flop (didn't bet)
Seat 8: JorgeCross5 (button) folded before Flop (didn't bet)
Seat 9: @tico0503 (small blind) showed [7s 7d] and won (5926) with a pair of Sevens



PokerStars Home Game Hand #211091658247: {Club #3217684} Tournament #2845705715, 17000+3000 Hold'em No Limit - Level XV (350/700) - 2020/03/31 23:14:51 ET
Table '2845705715 2' 9-max Seat #9 is the button
Seat 1: FJara07 (18395 in chips) 
Seat 2: rafinha.nr (31505 in chips) 
Seat 3: LGPRENDES (18007 in chips) 
Seat 5: DinKinG 88 (8546 in chips) 
Seat 6: flagao (21268 in chips) 
Seat 7: beça07 (9288 in chips) 
Seat 8: JorgeCross5 (20527 in chips) 
Seat 9: @tico0503 (5926 in chips) 
FJara07: posts the ante 85
rafinha.nr: posts the ante 85
LGPRENDES: posts the ante 85
DinKinG 88: posts the ante 85
flagao: posts the ante 85
beça07: posts the ante 85
JorgeCross5: posts the ante 85
@tico0503: posts the ante 85
FJara07: posts small blind 350
rafinha.nr: posts big blind 700
*** HOLE CARDS ***
Dealt to flagao [Ad 3s]
LGPRENDES: folds 
DinKinG 88: calls 700
flagao: folds 
beça07: calls 700
JorgeCross5: folds 
@tico0503: folds 
FJara07: folds 
rafinha.nr: checks 
*** FLOP *** [Td Ks 2s]
rafinha.nr: bets 700
DinKinG 88: calls 700
beça07: calls 700
*** TURN *** [Td Ks 2s] [Jd]
rafinha.nr: bets 1500
DinKinG 88: calls 1500
beça07: calls 1500
*** RIVER *** [Td Ks 2s Jd] [8c]
rafinha.nr: bets 2500
DinKinG 88: folds 
beça07: folds 
Uncalled bet (2500) returned to rafinha.nr
rafinha.nr collected 9730 from pot
*** SUMMARY ***
Total pot 9730 | Rake 0 
Board [Td Ks 2s Jd 8c]
Seat 1: FJara07 (small blind) folded before Flop
Seat 2: rafinha.nr (big blind) collected (9730)
Seat 3: LGPRENDES folded before Flop (didn't bet)
Seat 5: DinKinG 88 folded on the River
Seat 6: flagao folded before Flop (didn't bet)
Seat 7: beça07 folded on the River
Seat 8: JorgeCross5 folded before Flop (didn't bet)
Seat 9: @tico0503 (button) folded before Flop (didn't bet)



PokerStars Home Game Hand #211091695349: {Club #3217684} Tournament #2845705715, 17000+3000 Hold'em No Limit - Level XV (350/700) - 2020/03/31 23:16:15 ET
Table '2845705715 2' 9-max Seat #1 is the button
Seat 1: FJara07 (17960 in chips) 
Seat 2: rafinha.nr (38250 in chips) 
Seat 3: LGPRENDES (17922 in chips) 
Seat 5: DinKinG 88 (5561 in chips) 
Seat 6: flagao (21183 in chips) 
Seat 7: beça07 (6303 in chips) 
Seat 8: JorgeCross5 (20442 in chips) 
Seat 9: @tico0503 (5841 in chips) 
FJara07: posts the ante 85
rafinha.nr: posts the ante 85
LGPRENDES: posts the ante 85
DinKinG 88: posts the ante 85
flagao: posts the ante 85
beça07: posts the ante 85
JorgeCross5: posts the ante 85
@tico0503: posts the ante 85
rafinha.nr: posts small blind 350
LGPRENDES: posts big blind 700
*** HOLE CARDS ***
Dealt to flagao [Qs 4h]
rafinha.nr said, "eu tb"
DinKinG 88: calls 700
flagao: folds 
beça07: folds 
JorgeCross5: folds 
@tico0503: folds 
FJara07: folds 
rafinha.nr: folds 
LGPRENDES is disconnected 
LGPRENDES has timed out while disconnected
LGPRENDES: checks 
*** FLOP *** [6d Jc As]
LGPRENDES has timed out while disconnected
LGPRENDES: checks 
DinKinG 88: bets 700
LGPRENDES: folds 
Uncalled bet (700) returned to DinKinG 88
DinKinG 88 collected 2430 from pot
DinKinG 88: doesn't show hand 
*** SUMMARY ***
Total pot 2430 | Rake 0 
Board [6d Jc As]
Seat 1: FJara07 (button) folded before Flop (didn't bet)
Seat 2: rafinha.nr (small blind) folded before Flop
Seat 3: LGPRENDES (big blind) folded on the Flop
Seat 5: DinKinG 88 collected (2430)
Seat 6: flagao folded before Flop (didn't bet)
Seat 7: beça07 folded before Flop (didn't bet)
Seat 8: JorgeCross5 folded before Flop (didn't bet)
Seat 9: @tico0503 folded before Flop (didn't bet)



PokerStars Home Game Hand #211091733287: {Club #3217684} Tournament #2845705715, 17000+3000 Hold'em No Limit - Level XV (350/700) - 2020/03/31 23:17:40 ET
Table '2845705715 2' 9-max Seat #2 is the button
Seat 1: FJara07 (17875 in chips) 
Seat 2: rafinha.nr (37815 in chips) 
Seat 3: LGPRENDES (17137 in chips) 
Seat 5: DinKinG 88 (7206 in chips) 
Seat 6: flagao (21098 in chips) 
Seat 7: beça07 (6218 in chips) 
Seat 8: JorgeCross5 (20357 in chips) 
Seat 9: @tico0503 (5756 in chips) 
FJara07: posts the ante 85
rafinha.nr: posts the ante 85
LGPRENDES: posts the ante 85
DinKinG 88: posts the ante 85
flagao: posts the ante 85
beça07: posts the ante 85
JorgeCross5: posts the ante 85
@tico0503: posts the ante 85
LGPRENDES: posts small blind 350
DinKinG 88: posts big blind 700
*** HOLE CARDS ***
Dealt to flagao [Jh As]
flagao: raises 700 to 1400
beça07: folds 
JorgeCross5: folds 
@tico0503: folds 
FJara07: folds 
rafinha.nr: calls 1400
LGPRENDES: folds 
DinKinG 88: folds 
*** FLOP *** [Qc 2c 3d]
flagao: bets 1400
rafinha.nr: folds 
Uncalled bet (1400) returned to flagao
flagao collected 4530 from pot
flagao: doesn't show hand 
*** SUMMARY ***
Total pot 4530 | Rake 0 
Board [Qc 2c 3d]
Seat 1: FJara07 folded before Flop (didn't bet)
Seat 2: rafinha.nr (button) folded on the Flop
Seat 3: LGPRENDES (small blind) folded before Flop
Seat 5: DinKinG 88 (big blind) folded before Flop
Seat 6: flagao collected (4530)
Seat 7: beça07 folded before Flop (didn't bet)
Seat 8: JorgeCross5 folded before Flop (didn't bet)
Seat 9: @tico0503 folded before Flop (didn't bet)



PokerStars Home Game Hand #211091747336: {Club #3217684} Tournament #2845705715, 17000+3000 Hold'em No Limit - Level XV (350/700) - 2020/03/31 23:18:13 ET
Table '2845705715 2' 9-max Seat #3 is the button
Seat 1: FJara07 (17790 in chips) 
Seat 2: rafinha.nr (36330 in chips) 
Seat 3: LGPRENDES (16702 in chips) 
Seat 5: DinKinG 88 (6421 in chips) 
Seat 6: flagao (24143 in chips) 
Seat 7: beça07 (6133 in chips) 
Seat 8: JorgeCross5 (20272 in chips) 
Seat 9: @tico0503 (5671 in chips) 
FJara07: posts the ante 85
rafinha.nr: posts the ante 85
LGPRENDES: posts the ante 85
DinKinG 88: posts the ante 85
flagao: posts the ante 85
beça07: posts the ante 85
JorgeCross5: posts the ante 85
@tico0503: posts the ante 85
DinKinG 88: posts small blind 350
flagao: posts big blind 700
*** HOLE CARDS ***
Dealt to flagao [Ah Jh]
beça07: raises 5348 to 6048 and is all-in
JorgeCross5: folds 
@tico0503: folds 
FJara07: folds 
rafinha.nr: folds 
LGPRENDES: folds 
DinKinG 88: folds 
flagao: calls 5348
*** FLOP *** [8c 7s Td]
*** TURN *** [8c 7s Td] [2d]
*** RIVER *** [8c 7s Td 2d] [Qd]
*** SHOW DOWN ***
flagao: shows [Ah Jh] (high card Ace)
beça07: shows [Qh Ac] (a pair of Queens)
beça07 collected 13126 from pot
rafinha.nr said, "segui n flop kkk"
*** SUMMARY ***
Total pot 13126 | Rake 0 
Board [8c 7s Td 2d Qd]
Seat 1: FJara07 folded before Flop (didn't bet)
Seat 2: rafinha.nr folded before Flop (didn't bet)
Seat 3: LGPRENDES (button) folded before Flop (didn't bet)
Seat 5: DinKinG 88 (small blind) folded before Flop
Seat 6: flagao (big blind) showed [Ah Jh] and lost with high card Ace
Seat 7: beça07 showed [Qh Ac] and won (13126) with a pair of Queens
Seat 8: JorgeCross5 folded before Flop (didn't bet)
Seat 9: @tico0503 folded before Flop (didn't bet)



PokerStars Home Game Hand #211091764572: {Club #3217684} Tournament #2845705715, 17000+3000 Hold'em No Limit - Level XV (350/700) - 2020/03/31 23:18:52 ET
Table '2845705715 2' 9-max Seat #5 is the button
Seat 1: FJara07 (17705 in chips) 
Seat 2: rafinha.nr (36245 in chips) 
Seat 3: LGPRENDES (16617 in chips) 
Seat 5: DinKinG 88 (5986 in chips) 
Seat 6: flagao (18010 in chips) 
Seat 7: beça07 (13126 in chips) 
Seat 8: JorgeCross5 (20187 in chips) 
Seat 9: @tico0503 (5586 in chips) 
FJara07: posts the ante 85
rafinha.nr: posts the ante 85
LGPRENDES: posts the ante 85
DinKinG 88: posts the ante 85
flagao: posts the ante 85
beça07: posts the ante 85
JorgeCross5: posts the ante 85
@tico0503: posts the ante 85
flagao: posts small blind 350
beça07: posts big blind 700
*** HOLE CARDS ***
Dealt to flagao [9h 5c]
rafinha.nr said, "kkkk"
JorgeCross5: calls 700
@tico0503: folds 
FJara07: folds 
rafinha.nr: folds 
LGPRENDES: folds 
DinKinG 88: raises 5201 to 5901 and is all-in
flagao: folds 
beça07: folds 
JorgeCross5: calls 5201
*** FLOP *** [Jh Ac 2s]
*** TURN *** [Jh Ac 2s] [Ad]
*** RIVER *** [Jh Ac 2s Ad] [4c]
*** SHOW DOWN ***
JorgeCross5: shows [Ah Td] (three of a kind, Aces)
DinKinG 88: shows [6d 6h] (two pair, Aces and Sixes)
JorgeCross5 collected 13532 from pot
DinKinG 88 finished the tournament in 15th place
*** SUMMARY ***
Total pot 13532 | Rake 0 
Board [Jh Ac 2s Ad 4c]
Seat 1: FJara07 folded before Flop (didn't bet)
Seat 2: rafinha.nr folded before Flop (didn't bet)
Seat 3: LGPRENDES folded before Flop (didn't bet)
Seat 5: DinKinG 88 (button) showed [6d 6h] and lost with two pair, Aces and Sixes
Seat 6: flagao (small blind) folded before Flop
Seat 7: beça07 (big blind) folded before Flop
Seat 8: JorgeCross5 showed [Ah Td] and won (13532) with three of a kind, Aces
Seat 9: @tico0503 folded before Flop (didn't bet)



PokerStars Home Game Hand #211091784587: {Club #3217684} Tournament #2845705715, 17000+3000 Hold'em No Limit - Level XV (350/700) - 2020/03/31 23:19:38 ET
Table '2845705715 2' 9-max Seat #6 is the button
Seat 1: FJara07 (17620 in chips) 
Seat 2: rafinha.nr (36160 in chips) 
Seat 3: LGPRENDES (16532 in chips) 
Seat 6: flagao (17575 in chips) 
Seat 7: beça07 (12341 in chips) 
Seat 8: JorgeCross5 (27733 in chips) 
Seat 9: @tico0503 (5501 in chips) 
FJara07: posts the ante 85
rafinha.nr: posts the ante 85
LGPRENDES: posts the ante 85
flagao: posts the ante 85
beça07: posts the ante 85
JorgeCross5: posts the ante 85
@tico0503: posts the ante 85
beça07: posts small blind 350
JorgeCross5: posts big blind 700
*** HOLE CARDS ***
Dealt to flagao [8s Jc]
@tico0503: raises 700 to 1400
FJara07: folds 
rafinha.nr: folds 
LGPRENDES: calls 1400
flagao: folds 
beça07: folds 
JorgeCross5: folds 
*** FLOP *** [Ah Ac 5c]
@tico0503: bets 4016 and is all-in
LGPRENDES: folds 
Uncalled bet (4016) returned to @tico0503
@tico0503 collected 4445 from pot
@tico0503: doesn't show hand 
*** SUMMARY ***
Total pot 4445 | Rake 0 
Board [Ah Ac 5c]
Seat 1: FJara07 folded before Flop (didn't bet)
Seat 2: rafinha.nr folded before Flop (didn't bet)
Seat 3: LGPRENDES folded on the Flop
Seat 6: flagao (button) folded before Flop (didn't bet)
Seat 7: beça07 (small blind) folded before Flop
Seat 8: JorgeCross5 (big blind) folded before Flop
Seat 9: @tico0503 collected (4445)



PokerStars Home Game Hand #211091808083: {Club #3217684} Tournament #2845705715, 17000+3000 Hold'em No Limit - Level XV (350/700) - 2020/03/31 23:20:32 ET
Table '2845705715 2' 9-max Seat #7 is the button
Seat 1: FJara07 (17535 in chips) 
Seat 2: rafinha.nr (36075 in chips) 
Seat 3: LGPRENDES (15047 in chips) 
Seat 6: flagao (17490 in chips) 
Seat 7: beça07 (11906 in chips) 
Seat 8: JorgeCross5 (26948 in chips) 
Seat 9: @tico0503 (8461 in chips) 
FJara07: posts the ante 85
rafinha.nr: posts the ante 85
LGPRENDES: posts the ante 85
flagao: posts the ante 85
beça07: posts the ante 85
JorgeCross5: posts the ante 85
@tico0503: posts the ante 85
JorgeCross5: posts small blind 350
@tico0503: posts big blind 700
*** HOLE CARDS ***
Dealt to flagao [Th Js]
FJara07: folds 
rafinha.nr: calls 700
LGPRENDES: folds 
flagao: folds 
beça07: calls 700
JorgeCross5: folds 
@tico0503: checks 
*** FLOP *** [6d Kd 3d]
@tico0503: checks 
rafinha.nr: bets 1500
beça07: calls 1500
@tico0503: folds 
*** TURN *** [6d Kd 3d] [9d]
rafinha.nr: bets 1500
beça07: calls 1500
*** RIVER *** [6d Kd 3d 9d] [Jc]
rafinha.nr: bets 3000
beça07: calls 3000
*** SHOW DOWN ***
rafinha.nr: shows [9h Ks] (two pair, Kings and Nines)
beça07: shows [Jh Qd] (a flush, King high)
beça07 collected 15045 from pot
*** SUMMARY ***
Total pot 15045 | Rake 0 
Board [6d Kd 3d 9d Jc]
Seat 1: FJara07 folded before Flop (didn't bet)
Seat 2: rafinha.nr showed [9h Ks] and lost with two pair, Kings and Nines
Seat 3: LGPRENDES folded before Flop (didn't bet)
Seat 6: flagao folded before Flop (didn't bet)
Seat 7: beça07 (button) showed [Jh Qd] and won (15045) with a flush, King high
Seat 8: JorgeCross5 (small blind) folded before Flop
Seat 9: @tico0503 (big blind) folded on the Flop



PokerStars Home Game Hand #211091843257: {Club #3217684} Tournament #2845705715, 17000+3000 Hold'em No Limit - Level XV (350/700) - 2020/03/31 23:21:29 ET
Table '2845705715 2' 9-max Seat #8 is the button
Seat 1: FJara07 (17450 in chips) 
Seat 2: rafinha.nr (29290 in chips) 
Seat 3: LGPRENDES (14962 in chips) 
Seat 6: flagao (17405 in chips) 
Seat 7: beça07 (20166 in chips) 
Seat 8: JorgeCross5 (26513 in chips) 
Seat 9: @tico0503 (7676 in chips) 
FJara07: posts the ante 85
rafinha.nr: posts the ante 85
LGPRENDES: posts the ante 85
flagao: posts the ante 85
beça07: posts the ante 85
JorgeCross5: posts the ante 85
@tico0503: posts the ante 85
@tico0503: posts small blind 350
FJara07: posts big blind 700
*** HOLE CARDS ***
Dealt to flagao [4c 5h]
rafinha.nr: folds 
LGPRENDES: folds 
flagao: folds 
beça07: calls 700
JorgeCross5: folds 
@tico0503: calls 350
FJara07: checks 
*** FLOP *** [Ks Qc 5c]
@tico0503: checks 
FJara07: checks 
rafinha.nr said, "fui msm flagao kkk"
beça07: checks 
*** TURN *** [Ks Qc 5c] [3s]
@tico0503: checks 
FJara07: checks 
beça07: checks 
*** RIVER *** [Ks Qc 5c 3s] [7d]
@tico0503: checks 
FJara07: bets 1400
beça07: folds 
@tico0503: folds 
Uncalled bet (1400) returned to FJara07
FJara07 collected 2695 from pot
FJara07: doesn't show hand 
*** SUMMARY ***
Total pot 2695 | Rake 0 
Board [Ks Qc 5c 3s 7d]
Seat 1: FJara07 (big blind) collected (2695)
Seat 2: rafinha.nr folded before Flop (didn't bet)
Seat 3: LGPRENDES folded before Flop (didn't bet)
Seat 6: flagao folded before Flop (didn't bet)
Seat 7: beça07 folded on the River
Seat 8: JorgeCross5 (button) folded before Flop (didn't bet)
Seat 9: @tico0503 (small blind) folded on the River



PokerStars Home Game Hand #211091867452: {Club #3217684} Tournament #2845705715, 17000+3000 Hold'em No Limit - Level XV (350/700) - 2020/03/31 23:22:24 ET
Table '2845705715 2' 9-max Seat #9 is the button
Seat 1: FJara07 (19360 in chips) 
Seat 2: rafinha.nr (29205 in chips) 
Seat 3: LGPRENDES (14877 in chips) 
Seat 6: flagao (17320 in chips) 
Seat 7: beça07 (19381 in chips) 
Seat 8: JorgeCross5 (26428 in chips) 
Seat 9: @tico0503 (6891 in chips) 
FJara07: posts the ante 85
rafinha.nr: posts the ante 85
LGPRENDES: posts the ante 85
flagao: posts the ante 85
beça07: posts the ante 85
JorgeCross5: posts the ante 85
@tico0503: posts the ante 85
FJara07: posts small blind 350
rafinha.nr: posts big blind 700
*** HOLE CARDS ***
Dealt to flagao [Jc 8s]
LGPRENDES: folds 
flagao: folds 
beça07: calls 700
JorgeCross5: folds 
@tico0503: folds 
FJara07: calls 350
rafinha.nr: checks 
*** FLOP *** [Jh Th As]
FJara07: checks 
rafinha.nr: checks 
beça07: bets 2100
FJara07: calls 2100
rafinha.nr: folds 
*** TURN *** [Jh Th As] [2d]
FJara07: checks 
beça07: bets 2100
FJara07: calls 2100
*** RIVER *** [Jh Th As 2d] [9s]
FJara07: checks 
beça07: bets 4200
FJara07: folds 
Uncalled bet (4200) returned to beça07
beça07 collected 11095 from pot
beça07: doesn't show hand 
*** SUMMARY ***
Total pot 11095 | Rake 0 
Board [Jh Th As 2d 9s]
Seat 1: FJara07 (small blind) folded on the River
Seat 2: rafinha.nr (big blind) folded on the Flop
Seat 3: LGPRENDES folded before Flop (didn't bet)
Seat 6: flagao folded before Flop (didn't bet)
Seat 7: beça07 collected (11095)
Seat 8: JorgeCross5 folded before Flop (didn't bet)
Seat 9: @tico0503 (button) folded before Flop (didn't bet)



PokerStars Home Game Hand #211091891771: {Club #3217684} Tournament #2845705715, 17000+3000 Hold'em No Limit - Level XV (350/700) - 2020/03/31 23:23:20 ET
Table '2845705715 2' 9-max Seat #1 is the button
Seat 1: FJara07 (14375 in chips) 
Seat 2: rafinha.nr (28420 in chips) 
Seat 3: LGPRENDES (14792 in chips) 
Seat 6: flagao (17235 in chips) 
Seat 7: beça07 (25491 in chips) 
Seat 8: JorgeCross5 (26343 in chips) 
Seat 9: @tico0503 (6806 in chips) 
FJara07: posts the ante 85
rafinha.nr: posts the ante 85
LGPRENDES: posts the ante 85
flagao: posts the ante 85
beça07: posts the ante 85
JorgeCross5: posts the ante 85
@tico0503: posts the ante 85
rafinha.nr: posts small blind 350
LGPRENDES: posts big blind 700
*** HOLE CARDS ***
Dealt to flagao [6h Jh]
flagao: folds 
beça07: calls 700
JorgeCross5: folds 
@tico0503: folds 
FJara07: calls 700
rafinha.nr: folds 
LGPRENDES: checks 
*** FLOP *** [Ks Kh 4c]
LGPRENDES: checks 
beça07: checks 
FJara07: checks 
*** TURN *** [Ks Kh 4c] [Td]
LGPRENDES: checks 
beça07: checks 
FJara07: bets 2100
LGPRENDES: folds 
beça07: folds 
Uncalled bet (2100) returned to FJara07
FJara07 collected 3045 from pot
FJara07: doesn't show hand 
*** SUMMARY ***
Total pot 3045 | Rake 0 
Board [Ks Kh 4c Td]
Seat 1: FJara07 (button) collected (3045)
Seat 2: rafinha.nr (small blind) folded before Flop
Seat 3: LGPRENDES (big blind) folded on the Turn
Seat 6: flagao folded before Flop (didn't bet)
Seat 7: beça07 folded on the Turn
Seat 8: JorgeCross5 folded before Flop (didn't bet)
Seat 9: @tico0503 folded before Flop (didn't bet)



PokerStars Home Game Hand #211091917112: {Club #3217684} Tournament #2845705715, 17000+3000 Hold'em No Limit - Level XV (350/700) - 2020/03/31 23:24:05 ET
Table '2845705715 2' 9-max Seat #2 is the button
Seat 1: FJara07 (16635 in chips) 
Seat 2: rafinha.nr (27985 in chips) 
Seat 3: LGPRENDES (14007 in chips) 
Seat 6: flagao (17150 in chips) 
Seat 7: beça07 (24706 in chips) 
Seat 8: JorgeCross5 (26258 in chips) 
Seat 9: @tico0503 (6721 in chips) 
FJara07: posts the ante 85
rafinha.nr: posts the ante 85
LGPRENDES: posts the ante 85
flagao: posts the ante 85
beça07: posts the ante 85
JorgeCross5: posts the ante 85
@tico0503: posts the ante 85
LGPRENDES: posts small blind 350
flagao: posts big blind 700
*** HOLE CARDS ***
Dealt to flagao [8c 2c]
beça07: folds 
JorgeCross5: folds 
@tico0503: folds 
FJara07: folds 
rafinha.nr: folds 
LGPRENDES: calls 350
flagao: checks 
*** FLOP *** [Kd Ah 7d]
LGPRENDES: bets 700
flagao: folds 
Uncalled bet (700) returned to LGPRENDES
LGPRENDES collected 1995 from pot
LGPRENDES: doesn't show hand 
*** SUMMARY ***
Total pot 1995 | Rake 0 
Board [Kd Ah 7d]
Seat 1: FJara07 folded before Flop (didn't bet)
Seat 2: rafinha.nr (button) folded before Flop (didn't bet)
Seat 3: LGPRENDES (small blind) collected (1995)
Seat 6: flagao (big blind) folded on the Flop
Seat 7: beça07 folded before Flop (didn't bet)
Seat 8: JorgeCross5 folded before Flop (didn't bet)
Seat 9: @tico0503 folded before Flop (didn't bet)



PokerStars Home Game Hand #211091928848: {Club #3217684} Tournament #2845705715, 17000+3000 Hold'em No Limit - Level XV (350/700) - 2020/03/31 23:24:33 ET
Table '2845705715 2' 9-max Seat #3 is the button
Seat 1: FJara07 (16550 in chips) 
Seat 2: rafinha.nr (27900 in chips) 
Seat 3: LGPRENDES (15217 in chips) 
Seat 6: flagao (16365 in chips) 
Seat 7: beça07 (24621 in chips) 
Seat 8: JorgeCross5 (26173 in chips) 
Seat 9: @tico0503 (6636 in chips) 
FJara07: posts the ante 85
rafinha.nr: posts the ante 85
LGPRENDES: posts the ante 85
flagao: posts the ante 85
beça07: posts the ante 85
JorgeCross5: posts the ante 85
@tico0503: posts the ante 85
flagao: posts small blind 350
beça07: posts big blind 700
*** HOLE CARDS ***
Dealt to flagao [4h Jd]
JorgeCross5: folds 
@tico0503: folds 
FJara07: folds 
rafinha.nr: folds 
LGPRENDES: folds 
flagao: folds 
Uncalled bet (350) returned to beça07
beça07 collected 1295 from pot
beça07: doesn't show hand 
*** SUMMARY ***
Total pot 1295 | Rake 0 
Seat 1: FJara07 folded before Flop (didn't bet)
Seat 2: rafinha.nr folded before Flop (didn't bet)
Seat 3: LGPRENDES (button) folded before Flop (didn't bet)
Seat 6: flagao (small blind) folded before Flop
Seat 7: beça07 (big blind) collected (1295)
Seat 8: JorgeCross5 folded before Flop (didn't bet)
Seat 9: @tico0503 folded before Flop (didn't bet)



PokerStars Home Game Hand #211091938650: {Club #3217684} Tournament #2845705715, 17000+3000 Hold'em No Limit - Level XVI (400/800) - 2020/03/31 23:24:55 ET
Table '2845705715 2' 9-max Seat #6 is the button
Seat 1: FJara07 (16465 in chips) 
Seat 2: rafinha.nr (27815 in chips) 
Seat 3: LGPRENDES (15132 in chips) 
Seat 6: flagao (15930 in chips) 
Seat 7: beça07 (25481 in chips) 
Seat 8: JorgeCross5 (26088 in chips) 
Seat 9: @tico0503 (6551 in chips) 
FJara07: posts the ante 100
rafinha.nr: posts the ante 100
LGPRENDES: posts the ante 100
flagao: posts the ante 100
beça07: posts the ante 100
JorgeCross5: posts the ante 100
@tico0503: posts the ante 100
beça07: posts small blind 400
JorgeCross5: posts big blind 800
*** HOLE CARDS ***
Dealt to flagao [3d 9d]
@tico0503: folds 
FJara07: folds 
rafinha.nr: calls 800
LGPRENDES: folds 
flagao: folds 
beça07: calls 400
JorgeCross5: checks 
*** FLOP *** [4d Kh 5s]
beça07: checks 
JorgeCross5: checks 
rafinha.nr: bets 1600
beça07: folds 
JorgeCross5: folds 
Uncalled bet (1600) returned to rafinha.nr
rafinha.nr collected 3100 from pot
rafinha.nr: doesn't show hand 
*** SUMMARY ***
Total pot 3100 | Rake 0 
Board [4d Kh 5s]
Seat 1: FJara07 folded before Flop (didn't bet)
Seat 2: rafinha.nr collected (3100)
Seat 3: LGPRENDES folded before Flop (didn't bet)
Seat 6: flagao (button) folded before Flop (didn't bet)
Seat 7: beça07 (small blind) folded on the Flop
Seat 8: JorgeCross5 (big blind) folded on the Flop
Seat 9: @tico0503 folded before Flop (didn't bet)



PokerStars Home Game Hand #211091960721: {Club #3217684} Tournament #2845705715, 17000+3000 Hold'em No Limit - Level XVI (400/800) - 2020/03/31 23:25:47 ET
Table '2845705715 2' 9-max Seat #7 is the button
Seat 1: FJara07 (16365 in chips) 
Seat 2: rafinha.nr (30015 in chips) 
Seat 3: LGPRENDES (15032 in chips) 
Seat 6: flagao (15830 in chips) 
Seat 7: beça07 (24581 in chips) 
Seat 8: JorgeCross5 (25188 in chips) 
Seat 9: @tico0503 (6451 in chips) 
FJara07: posts the ante 100
rafinha.nr: posts the ante 100
LGPRENDES: posts the ante 100
flagao: posts the ante 100
beça07: posts the ante 100
JorgeCross5: posts the ante 100
@tico0503: posts the ante 100
JorgeCross5: posts small blind 400
@tico0503: posts big blind 800
*** HOLE CARDS ***
Dealt to flagao [Qd Kd]
FJara07: folds 
rafinha.nr: folds 
LGPRENDES: folds 
flagao: raises 800 to 1600
beça07: folds 
JorgeCross5: folds 
@tico0503: folds 
Uncalled bet (800) returned to flagao
flagao collected 2700 from pot
flagao: doesn't show hand 
*** SUMMARY ***
Total pot 2700 | Rake 0 
Seat 1: FJara07 folded before Flop (didn't bet)
Seat 2: rafinha.nr folded before Flop (didn't bet)
Seat 3: LGPRENDES folded before Flop (didn't bet)
Seat 6: flagao collected (2700)
Seat 7: beça07 (button) folded before Flop (didn't bet)
Seat 8: JorgeCross5 (small blind) folded before Flop
Seat 9: @tico0503 (big blind) folded before Flop



PokerStars Home Game Hand #211091974970: {Club #3217684} Tournament #2845705715, 17000+3000 Hold'em No Limit - Level XVI (400/800) - 2020/03/31 23:26:20 ET
Table '2845705715 2' 9-max Seat #8 is the button
Seat 1: FJara07 (16265 in chips) 
Seat 2: rafinha.nr (29915 in chips) 
Seat 3: LGPRENDES (14932 in chips) 
Seat 6: flagao (17630 in chips) 
Seat 7: beça07 (24481 in chips) 
Seat 8: JorgeCross5 (24688 in chips) 
Seat 9: @tico0503 (5551 in chips) 
FJara07: posts the ante 100
rafinha.nr: posts the ante 100
LGPRENDES: posts the ante 100
flagao: posts the ante 100
beça07: posts the ante 100
JorgeCross5: posts the ante 100
@tico0503: posts the ante 100
@tico0503: posts small blind 400
FJara07: posts big blind 800
*** HOLE CARDS ***
Dealt to flagao [Qc 5c]
rafinha.nr: raises 800 to 1600
LGPRENDES: folds 
flagao: folds 
beça07: folds 
JorgeCross5: folds 
@tico0503: folds 
FJara07: folds 
Uncalled bet (800) returned to rafinha.nr
rafinha.nr collected 2700 from pot
rafinha.nr: doesn't show hand 
*** SUMMARY ***
Total pot 2700 | Rake 0 
Seat 1: FJara07 (big blind) folded before Flop
Seat 2: rafinha.nr collected (2700)
Seat 3: LGPRENDES folded before Flop (didn't bet)
Seat 6: flagao folded before Flop (didn't bet)
Seat 7: beça07 folded before Flop (didn't bet)
Seat 8: JorgeCross5 (button) folded before Flop (didn't bet)
Seat 9: @tico0503 (small blind) folded before Flop



PokerStars Home Game Hand #211091985143: {Club #3217684} Tournament #2845705715, 17000+3000 Hold'em No Limit - Level XVI (400/800) - 2020/03/31 23:26:44 ET
Table '2845705715 2' 9-max Seat #9 is the button
Seat 1: FJara07 (15365 in chips) 
Seat 2: rafinha.nr (31715 in chips) 
Seat 3: LGPRENDES (14832 in chips) 
Seat 6: flagao (17530 in chips) 
Seat 7: beça07 (24381 in chips) 
Seat 8: JorgeCross5 (24588 in chips) 
Seat 9: @tico0503 (5051 in chips) 
FJara07: posts the ante 100
rafinha.nr: posts the ante 100
LGPRENDES: posts the ante 100
flagao: posts the ante 100
beça07: posts the ante 100
JorgeCross5: posts the ante 100
@tico0503: posts the ante 100
FJara07: posts small blind 400
rafinha.nr: posts big blind 800
*** HOLE CARDS ***
Dealt to flagao [3d Jh]
LGPRENDES: calls 800
flagao: folds 
beça07: calls 800
JorgeCross5: calls 800
@tico0503: folds 
FJara07: calls 400
rafinha.nr: checks 
*** FLOP *** [4h Qc Th]
FJara07: bets 2400
rafinha.nr: folds 
LGPRENDES: calls 2400
beça07: folds 
JorgeCross5: folds 
*** TURN *** [4h Qc Th] [4c]
FJara07: bets 3200
LGPRENDES: calls 3200
*** RIVER *** [4h Qc Th 4c] [8d]
FJara07: checks 
LGPRENDES: checks 
*** SHOW DOWN ***
FJara07: shows [Qd 9h] (two pair, Queens and Fours)
LGPRENDES: shows [Tc Qh] (two pair, Queens and Tens)
LGPRENDES collected 15900 from pot
*** SUMMARY ***
Total pot 15900 | Rake 0 
Board [4h Qc Th 4c 8d]
Seat 1: FJara07 (small blind) showed [Qd 9h] and lost with two pair, Queens and Fours
Seat 2: rafinha.nr (big blind) folded on the Flop
Seat 3: LGPRENDES showed [Tc Qh] and won (15900) with two pair, Queens and Tens
Seat 6: flagao folded before Flop (didn't bet)
Seat 7: beça07 folded on the Flop
Seat 8: JorgeCross5 folded on the Flop
Seat 9: @tico0503 (button) folded before Flop (didn't bet)



PokerStars Home Game Hand #211092029067: {Club #3217684} Tournament #2845705715, 17000+3000 Hold'em No Limit - Level XVI (400/800) - 2020/03/31 23:28:27 ET
Table '2845705715 2' 9-max Seat #1 is the button
Seat 1: FJara07 (8865 in chips) 
Seat 2: rafinha.nr (30815 in chips) 
Seat 3: LGPRENDES (24232 in chips) 
Seat 6: flagao (17430 in chips) 
Seat 7: beça07 (23481 in chips) 
Seat 8: JorgeCross5 (23688 in chips) 
Seat 9: @tico0503 (4951 in chips) 
FJara07: posts the ante 100
rafinha.nr: posts the ante 100
LGPRENDES: posts the ante 100
flagao: posts the ante 100
beça07: posts the ante 100
JorgeCross5: posts the ante 100
@tico0503: posts the ante 100
rafinha.nr: posts small blind 400
LGPRENDES: posts big blind 800
*** HOLE CARDS ***
Dealt to flagao [6s 2h]
flagao: folds 
beça07: folds 
JorgeCross5: folds 
@tico0503: raises 800 to 1600
FJara07: folds 
rafinha.nr: folds 
LGPRENDES: calls 800
*** FLOP *** [6c 4h 7s]
LGPRENDES: checks 
@tico0503: bets 3251 and is all-in
LGPRENDES: folds 
Uncalled bet (3251) returned to @tico0503
@tico0503 collected 4300 from pot
@tico0503: doesn't show hand 
*** SUMMARY ***
Total pot 4300 | Rake 0 
Board [6c 4h 7s]
Seat 1: FJara07 (button) folded before Flop (didn't bet)
Seat 2: rafinha.nr (small blind) folded before Flop
Seat 3: LGPRENDES (big blind) folded on the Flop
Seat 6: flagao folded before Flop (didn't bet)
Seat 7: beça07 folded before Flop (didn't bet)
Seat 8: JorgeCross5 folded before Flop (didn't bet)
Seat 9: @tico0503 collected (4300)



PokerStars Home Game Hand #211092048166: {Club #3217684} Tournament #2845705715, 17000+3000 Hold'em No Limit - Level XVI (400/800) - 2020/03/31 23:29:12 ET
Table '2845705715 2' 9-max Seat #2 is the button
Seat 1: FJara07 (8765 in chips) 
Seat 2: rafinha.nr (30315 in chips) 
Seat 3: LGPRENDES (22532 in chips) 
Seat 6: flagao (17330 in chips) 
Seat 7: beça07 (23381 in chips) 
Seat 8: JorgeCross5 (23588 in chips) 
Seat 9: @tico0503 (7551 in chips) 
FJara07: posts the ante 100
rafinha.nr: posts the ante 100
LGPRENDES: posts the ante 100
flagao: posts the ante 100
beça07: posts the ante 100
JorgeCross5: posts the ante 100
@tico0503: posts the ante 100
LGPRENDES: posts small blind 400
flagao: posts big blind 800
*** HOLE CARDS ***
Dealt to flagao [3h Ah]
beça07: calls 800
JorgeCross5: folds 
@tico0503: folds 
FJara07: calls 800
rafinha.nr: calls 800
LGPRENDES: calls 400
flagao: checks 
*** FLOP *** [8h 5d 2h]
LGPRENDES: checks 
flagao: bets 1600
beça07: folds 
FJara07: folds 
rafinha.nr: folds 
LGPRENDES: folds 
Uncalled bet (1600) returned to flagao
flagao collected 4700 from pot
flagao: doesn't show hand 
*** SUMMARY ***
Total pot 4700 | Rake 0 
Board [8h 5d 2h]
Seat 1: FJara07 folded on the Flop
Seat 2: rafinha.nr (button) folded on the Flop
Seat 3: LGPRENDES (small blind) folded on the Flop
Seat 6: flagao (big blind) collected (4700)
Seat 7: beça07 folded on the Flop
Seat 8: JorgeCross5 folded before Flop (didn't bet)
Seat 9: @tico0503 folded before Flop (didn't bet)



PokerStars Home Game Hand #211092072798: {Club #3217684} Tournament #2845705715, 17000+3000 Hold'em No Limit - Level XVI (400/800) - 2020/03/31 23:30:11 ET
Table '2845705715 2' 9-max Seat #3 is the button
Seat 1: FJara07 (7865 in chips) 
Seat 2: rafinha.nr (29415 in chips) 
Seat 3: LGPRENDES (21632 in chips) 
Seat 6: flagao (21130 in chips) 
Seat 7: beça07 (22481 in chips) 
Seat 8: JorgeCross5 (23488 in chips) 
Seat 9: @tico0503 (7451 in chips) 
FJara07: posts the ante 100
rafinha.nr: posts the ante 100
LGPRENDES: posts the ante 100
flagao: posts the ante 100
beça07: posts the ante 100
JorgeCross5: posts the ante 100
@tico0503: posts the ante 100
flagao: posts small blind 400
beça07: posts big blind 800
*** HOLE CARDS ***
Dealt to flagao [6d 7c]
JorgeCross5: calls 800
@tico0503: raises 2400 to 3200
FJara07: raises 4565 to 7765 and is all-in
rafinha.nr: folds 
LGPRENDES: folds 
flagao: folds 
beça07: folds 
JorgeCross5: raises 15623 to 23388 and is all-in
@tico0503: calls 4151 and is all-in
Uncalled bet (15623) returned to JorgeCross5
*** FLOP *** [4h 4s 8h]
*** TURN *** [4h 4s 8h] [8s]
*** RIVER *** [4h 4s 8h 8s] [Kh]
*** SHOW DOWN ***
JorgeCross5: shows [Ac Ah] (two pair, Aces and Eights)
FJara07: shows [7h 7d] (two pair, Eights and Sevens)
JorgeCross5 collected 828 from side pot
@tico0503: shows [Kc Ad] (two pair, Kings and Eights)
JorgeCross5 collected 23953 from main pot
FJara07 finished the tournament in 12th place
@tico0503 finished the tournament in 13th place
*** SUMMARY ***
Total pot 24781 Main pot 23953. Side pot 828. | Rake 0 
Board [4h 4s 8h 8s Kh]
Seat 1: FJara07 showed [7h 7d] and lost with two pair, Eights and Sevens
Seat 2: rafinha.nr folded before Flop (didn't bet)
Seat 3: LGPRENDES (button) folded before Flop (didn't bet)
Seat 6: flagao (small blind) folded before Flop
Seat 7: beça07 (big blind) folded before Flop
Seat 8: JorgeCross5 showed [Ac Ah] and won (24781) with two pair, Aces and Eights
Seat 9: @tico0503 showed [Kc Ad] and lost with two pair, Kings and Eights



PokerStars Home Game Hand #211092101903: {Club #3217684} Tournament #2845705715, 17000+3000 Hold'em No Limit - Level XVI (400/800) - 2020/03/31 23:31:20 ET
Table '2845705715 2' 9-max Seat #6 is the button
Seat 2: rafinha.nr (29315 in chips) 
Seat 3: LGPRENDES (21532 in chips) 
Seat 6: flagao (20630 in chips) 
Seat 7: beça07 (21581 in chips) 
Seat 8: JorgeCross5 (40404 in chips) 
rafinha.nr: posts the ante 100
LGPRENDES: posts the ante 100
flagao: posts the ante 100
beça07: posts the ante 100
JorgeCross5: posts the ante 100
beça07: posts small blind 400
JorgeCross5: posts big blind 800
*** HOLE CARDS ***
Dealt to flagao [Qs 6d]
rafinha.nr: raises 1900 to 2700
LGPRENDES: folds 
flagao: folds 
beça07: folds 
JorgeCross5: folds 
Uncalled bet (1900) returned to rafinha.nr
rafinha.nr collected 2500 from pot
rafinha.nr: doesn't show hand 
*** SUMMARY ***
Total pot 2500 | Rake 0 
Seat 2: rafinha.nr collected (2500)
Seat 3: LGPRENDES folded before Flop (didn't bet)
Seat 6: flagao (button) folded before Flop (didn't bet)
Seat 7: beça07 (small blind) folded before Flop
Seat 8: JorgeCross5 (big blind) folded before Flop



PokerStars Home Game Hand #211092114444: {Club #3217684} Tournament #2845705715, 17000+3000 Hold'em No Limit - Level XVI (400/800) - 2020/03/31 23:31:49 ET
Table '2845705715 2' 9-max Seat #7 is the button
Seat 2: rafinha.nr (30915 in chips) 
Seat 3: LGPRENDES (21432 in chips) 
Seat 6: flagao (20530 in chips) 
Seat 7: beça07 (21081 in chips) 
Seat 8: JorgeCross5 (39504 in chips) 
rafinha.nr: posts the ante 100
LGPRENDES: posts the ante 100
flagao: posts the ante 100
beça07: posts the ante 100
JorgeCross5: posts the ante 100
JorgeCross5: posts small blind 400
rafinha.nr: posts big blind 800
*** HOLE CARDS ***
Dealt to flagao [4h Kd]
LGPRENDES: calls 800
flagao: folds 
beça07: folds 
JorgeCross5: folds 
rafinha.nr: checks 
*** FLOP *** [7c Ad Qd]
rafinha.nr: checks 
LGPRENDES: bets 800
rafinha.nr: calls 800
*** TURN *** [7c Ad Qd] [4s]
rafinha.nr: checks 
LGPRENDES: bets 800
rafinha.nr: folds 
Uncalled bet (800) returned to LGPRENDES
LGPRENDES collected 4100 from pot
LGPRENDES: doesn't show hand 
*** SUMMARY ***
Total pot 4100 | Rake 0 
Board [7c Ad Qd 4s]
Seat 2: rafinha.nr (big blind) folded on the Turn
Seat 3: LGPRENDES collected (4100)
Seat 6: flagao folded before Flop (didn't bet)
Seat 7: beça07 (button) folded before Flop (didn't bet)
Seat 8: JorgeCross5 (small blind) folded before Flop



PokerStars Home Game Hand #211092133440: {Club #3217684} Tournament #2845705715, 17000+3000 Hold'em No Limit - Level XVI (400/800) - 2020/03/31 23:32:34 ET
Table '2845705715 2' 9-max Seat #8 is the button
Seat 2: rafinha.nr (29215 in chips) 
Seat 3: LGPRENDES (23832 in chips) 
Seat 6: flagao (20430 in chips) 
Seat 7: beça07 (20981 in chips) 
Seat 8: JorgeCross5 (39004 in chips) 
rafinha.nr: posts the ante 100
LGPRENDES: posts the ante 100
flagao: posts the ante 100
beça07: posts the ante 100
JorgeCross5: posts the ante 100
rafinha.nr: posts small blind 400
LGPRENDES: posts big blind 800
*** HOLE CARDS ***
Dealt to flagao [5d Qs]
flagao: folds 
beça07: raises 3200 to 4000
JorgeCross5: folds 
rafinha.nr: folds 
LGPRENDES: folds 
Uncalled bet (3200) returned to beça07
beça07 collected 2500 from pot
beça07: doesn't show hand 
*** SUMMARY ***
Total pot 2500 | Rake 0 
Seat 2: rafinha.nr (small blind) folded before Flop
Seat 3: LGPRENDES (big blind) folded before Flop
Seat 6: flagao folded before Flop (didn't bet)
Seat 7: beça07 collected (2500)
Seat 8: JorgeCross5 (button) folded before Flop (didn't bet)



PokerStars Home Game Hand #211092150044: {Club #3217684} Tournament #2845705715, 17000+3000 Hold'em No Limit - Level XVI (400/800) - 2020/03/31 23:33:14 ET
Table '2845705715 2' 9-max Seat #2 is the button
Seat 2: rafinha.nr (28715 in chips) 
Seat 3: LGPRENDES (22932 in chips) 
Seat 6: flagao (20330 in chips) 
Seat 7: beça07 (22581 in chips) 
Seat 8: JorgeCross5 (38904 in chips) 
rafinha.nr: posts the ante 100
LGPRENDES: posts the ante 100
flagao: posts the ante 100
beça07: posts the ante 100
JorgeCross5: posts the ante 100
LGPRENDES: posts small blind 400
flagao: posts big blind 800
*** HOLE CARDS ***
Dealt to flagao [3s Kc]
beça07: folds 
JorgeCross5: folds 
rafinha.nr: calls 800
LGPRENDES: folds 
flagao: checks 
*** FLOP *** [Qd 4d Qh]
flagao: bets 1600
rafinha.nr: folds 
Uncalled bet (1600) returned to flagao
flagao collected 2500 from pot
flagao: doesn't show hand 
*** SUMMARY ***
Total pot 2500 | Rake 0 
Board [Qd 4d Qh]
Seat 2: rafinha.nr (button) folded on the Flop
Seat 3: LGPRENDES (small blind) folded before Flop
Seat 6: flagao (big blind) collected (2500)
Seat 7: beça07 folded before Flop (didn't bet)
Seat 8: JorgeCross5 folded before Flop (didn't bet)



PokerStars Home Game Hand #211092165189: {Club #3217684} Tournament #2845705715, 17000+3000 Hold'em No Limit - Level XVI (400/800) - 2020/03/31 23:33:49 ET
Table '2845705715 2' 9-max Seat #3 is the button
Seat 2: rafinha.nr (27815 in chips) 
Seat 3: LGPRENDES (22432 in chips) 
Seat 6: flagao (21930 in chips) 
Seat 7: beça07 (22481 in chips) 
Seat 8: JorgeCross5 (38804 in chips) 
rafinha.nr: posts the ante 100
LGPRENDES: posts the ante 100
flagao: posts the ante 100
beça07: posts the ante 100
JorgeCross5: posts the ante 100
flagao: posts small blind 400
beça07: posts big blind 800
*** HOLE CARDS ***
Dealt to flagao [As 2d]
JorgeCross5: folds 
rafinha.nr: folds 
LGPRENDES: folds 
flagao: raises 800 to 1600
beça07: calls 800
*** FLOP *** [8c 6c 6s]
flagao: checks 
beça07: checks 
*** TURN *** [8c 6c 6s] [Qs]
flagao: bets 1600
beça07: calls 1600
*** RIVER *** [8c 6c 6s Qs] [Td]
flagao: bets 2400
beça07: folds 
Uncalled bet (2400) returned to flagao
flagao collected 6900 from pot
flagao: doesn't show hand 
*** SUMMARY ***
Total pot 6900 | Rake 0 
Board [8c 6c 6s Qs Td]
Seat 2: rafinha.nr folded before Flop (didn't bet)
Seat 3: LGPRENDES (button) folded before Flop (didn't bet)
Seat 6: flagao (small blind) collected (6900)
Seat 7: beça07 (big blind) folded on the River
Seat 8: JorgeCross5 folded before Flop (didn't bet)



PokerStars Home Game Hand #211092189279: {Club #3217684} Tournament #2845705715, 17000+3000 Hold'em No Limit - Level XVI (400/800) - 2020/03/31 23:34:33 ET
Table '2845705715 2' 9-max Seat #6 is the button
Seat 2: rafinha.nr (27715 in chips) 
Seat 3: LGPRENDES (22332 in chips) 
Seat 6: flagao (25530 in chips) 
Seat 7: beça07 (19181 in chips) 
Seat 8: JorgeCross5 (38704 in chips) 
rafinha.nr: posts the ante 100
LGPRENDES: posts the ante 100
flagao: posts the ante 100
beça07: posts the ante 100
JorgeCross5: posts the ante 100
beça07: posts small blind 400
JorgeCross5: posts big blind 800
*** HOLE CARDS ***
Dealt to flagao [7d 4c]
rafinha.nr: calls 800
LGPRENDES: folds 
flagao: folds 
beça07: calls 400
JorgeCross5: checks 
*** FLOP *** [Ac 5h 6c]
beça07: checks 
JorgeCross5: checks 
rafinha.nr: checks 
*** TURN *** [Ac 5h 6c] [6d]
beça07: checks 
JorgeCross5: checks 
rafinha.nr: checks 
*** RIVER *** [Ac 5h 6c 6d] [Ah]
beça07: checks 
JorgeCross5: checks 
rafinha.nr: checks 
*** SHOW DOWN ***
beça07: shows [Qc 2h] (two pair, Aces and Sixes)
JorgeCross5: mucks hand 
rafinha.nr: shows [Kd 8h] (two pair, Aces and Sixes - King kicker)
rafinha.nr collected 2900 from pot
*** SUMMARY ***
Total pot 2900 | Rake 0 
Board [Ac 5h 6c 6d Ah]
Seat 2: rafinha.nr showed [Kd 8h] and won (2900) with two pair, Aces and Sixes
Seat 3: LGPRENDES folded before Flop (didn't bet)
Seat 6: flagao (button) folded before Flop (didn't bet)
Seat 7: beça07 (small blind) showed [Qc 2h] and lost with two pair, Aces and Sixes
Seat 8: JorgeCross5 (big blind) mucked [3c 3d]



PokerStars Home Game Hand #211092208341: {Club #3217684} Tournament #2845705715, 17000+3000 Hold'em No Limit - Level XVII (500/1000) - 2020/03/31 23:35:18 ET
Table '2845705715 2' 9-max Seat #7 is the button
Seat 2: rafinha.nr (29715 in chips) 
Seat 3: LGPRENDES (22232 in chips) 
Seat 6: flagao (25430 in chips) 
Seat 7: beça07 (18281 in chips) 
Seat 8: JorgeCross5 (37804 in chips) 
rafinha.nr: posts the ante 125
LGPRENDES: posts the ante 125
flagao: posts the ante 125
beça07: posts the ante 125
JorgeCross5: posts the ante 125
JorgeCross5: posts small blind 500
rafinha.nr: posts big blind 1000
*** HOLE CARDS ***
Dealt to flagao [Qh Kd]
LGPRENDES: folds 
flagao: raises 1000 to 2000
beça07: folds 
JorgeCross5: folds 
rafinha.nr: folds 
Uncalled bet (1000) returned to flagao
flagao collected 3125 from pot
flagao: doesn't show hand 
*** SUMMARY ***
Total pot 3125 | Rake 0 
Seat 2: rafinha.nr (big blind) folded before Flop
Seat 3: LGPRENDES folded before Flop (didn't bet)
Seat 6: flagao collected (3125)
Seat 7: beça07 (button) folded before Flop (didn't bet)
Seat 8: JorgeCross5 (small blind) folded before Flop



PokerStars Home Game Hand #211092218105: {Club #3217684} Tournament #2845705715, 17000+3000 Hold'em No Limit - Level XVII (500/1000) - 2020/03/31 23:35:41 ET
Table '2845705715 2' 9-max Seat #8 is the button
Seat 2: rafinha.nr (28590 in chips) 
Seat 3: LGPRENDES (22107 in chips) 
Seat 6: flagao (27430 in chips) 
Seat 7: beça07 (18156 in chips) 
Seat 8: JorgeCross5 (37179 in chips) 
rafinha.nr: posts the ante 125
LGPRENDES: posts the ante 125
flagao: posts the ante 125
beça07: posts the ante 125
JorgeCross5: posts the ante 125
rafinha.nr: posts small blind 500
LGPRENDES: posts big blind 1000
*** HOLE CARDS ***
Dealt to flagao [7d 2d]
flagao: folds 
beça07: folds 
JorgeCross5: folds 
rafinha.nr: folds 
Uncalled bet (500) returned to LGPRENDES
LGPRENDES collected 1625 from pot
LGPRENDES: doesn't show hand 
*** SUMMARY ***
Total pot 1625 | Rake 0 
Seat 2: rafinha.nr (small blind) folded before Flop
Seat 3: LGPRENDES (big blind) collected (1625)
Seat 6: flagao folded before Flop (didn't bet)
Seat 7: beça07 folded before Flop (didn't bet)
Seat 8: JorgeCross5 (button) folded before Flop (didn't bet)



PokerStars Home Game Hand #211092225464: {Club #3217684} Tournament #2845705715, 17000+3000 Hold'em No Limit - Level XVII (500/1000) - 2020/03/31 23:35:59 ET
Table '2845705715 2' 9-max Seat #2 is the button
Seat 2: rafinha.nr (27965 in chips) 
Seat 3: LGPRENDES (23107 in chips) 
Seat 6: flagao (27305 in chips) 
Seat 7: beça07 (18031 in chips) 
Seat 8: JorgeCross5 (37054 in chips) 
rafinha.nr: posts the ante 125
LGPRENDES: posts the ante 125
flagao: posts the ante 125
beça07: posts the ante 125
JorgeCross5: posts the ante 125
LGPRENDES: posts small blind 500
flagao: posts big blind 1000
*** HOLE CARDS ***
Dealt to flagao [3h 7s]
beça07: folds 
JorgeCross5: folds 
rafinha.nr: calls 1000
LGPRENDES: calls 500
flagao: checks 
*** FLOP *** [Qh Ah 4c]
LGPRENDES: checks 
flagao: bets 2000
rafinha.nr: calls 2000
LGPRENDES: folds 
*** TURN *** [Qh Ah 4c] [4h]
flagao: bets 2000
rafinha.nr: calls 2000
*** RIVER *** [Qh Ah 4c 4h] [2s]
flagao: checks 
rafinha.nr: checks 
*** SHOW DOWN ***
flagao: shows [3h 7s] (a pair of Fours)
rafinha.nr: shows [As 9h] (two pair, Aces and Fours)
rafinha.nr collected 11625 from pot
*** SUMMARY ***
Total pot 11625 | Rake 0 
Board [Qh Ah 4c 4h 2s]
Seat 2: rafinha.nr (button) showed [As 9h] and won (11625) with two pair, Aces and Fours
Seat 3: LGPRENDES (small blind) folded on the Flop
Seat 6: flagao (big blind) showed [3h 7s] and lost with a pair of Fours
Seat 7: beça07 folded before Flop (didn't bet)
Seat 8: JorgeCross5 folded before Flop (didn't bet)



PokerStars Home Game Hand #211092251367: {Club #3217684} Tournament #2845705715, 17000+3000 Hold'em No Limit - Level XVII (500/1000) - 2020/03/31 23:37:01 ET
Table '2845705715 2' 9-max Seat #3 is the button
Seat 2: rafinha.nr (34465 in chips) 
Seat 3: LGPRENDES (21982 in chips) 
Seat 6: flagao (22180 in chips) 
Seat 7: beça07 (17906 in chips) 
Seat 8: JorgeCross5 (36929 in chips) 
rafinha.nr: posts the ante 125
LGPRENDES: posts the ante 125
flagao: posts the ante 125
beça07: posts the ante 125
JorgeCross5: posts the ante 125
flagao: posts small blind 500
beça07: posts big blind 1000
*** HOLE CARDS ***
Dealt to flagao [2c Js]
rafinha.nr said, "oxe"
rafinha.nr said, "safado"
rafinha.nr said, "kkk"
JorgeCross5: calls 1000
flagao said, "Tentei... hahaha errei"
rafinha.nr: raises 4000 to 5000
LGPRENDES: folds 
flagao: folds 
beça07: folds 
JorgeCross5: calls 4000
*** FLOP *** [Kh 6d Ks]
JorgeCross5: checks 
rafinha.nr: checks 
*** TURN *** [Kh 6d Ks] [5d]
JorgeCross5: checks 
rafinha.nr: bets 5000
JorgeCross5: folds 
Uncalled bet (5000) returned to rafinha.nr
rafinha.nr collected 12125 from pot
rafinha.nr: doesn't show hand 
*** SUMMARY ***
Total pot 12125 | Rake 0 
Board [Kh 6d Ks 5d]
Seat 2: rafinha.nr collected (12125)
Seat 3: LGPRENDES (button) folded before Flop (didn't bet)
Seat 6: flagao (small blind) folded before Flop
Seat 7: beça07 (big blind) folded before Flop
Seat 8: JorgeCross5 folded on the Turn



PokerStars Home Game Hand #211092276582: {Club #3217684} Tournament #2845705715, 17000+3000 Hold'em No Limit - Level XVII (500/1000) - 2020/03/31 23:38:01 ET
Table '2845705715 2' 9-max Seat #6 is the button
Seat 2: rafinha.nr (41465 in chips) 
Seat 3: LGPRENDES (21857 in chips) 
Seat 6: flagao (21555 in chips) 
Seat 7: beça07 (16781 in chips) 
Seat 8: JorgeCross5 (31804 in chips) 
rafinha.nr: posts the ante 125
LGPRENDES: posts the ante 125
flagao: posts the ante 125
beça07: posts the ante 125
JorgeCross5: posts the ante 125
beça07: posts small blind 500
JorgeCross5: posts big blind 1000
*** HOLE CARDS ***
Dealt to flagao [2s Kh]
rafinha.nr: folds 
LGPRENDES: folds 
flagao: raises 1000 to 2000
beça07: folds 
JorgeCross5: folds 
Uncalled bet (1000) returned to flagao
flagao collected 3125 from pot
flagao: doesn't show hand 
*** SUMMARY ***
Total pot 3125 | Rake 0 
Seat 2: rafinha.nr folded before Flop (didn't bet)
Seat 3: LGPRENDES folded before Flop (didn't bet)
Seat 6: flagao (button) collected (3125)
Seat 7: beça07 (small blind) folded before Flop
Seat 8: JorgeCross5 (big blind) folded before Flop



PokerStars Home Game Hand #211092293492: {Club #3217684} Tournament #2845705715, 17000+3000 Hold'em No Limit - Level XVII (500/1000) - 2020/03/31 23:38:35 ET
Table '2845705715 2' 9-max Seat #7 is the button
Seat 2: rafinha.nr (41340 in chips) 
Seat 3: LGPRENDES (21732 in chips) 
Seat 6: flagao (23555 in chips) 
Seat 7: beça07 (16156 in chips) 
Seat 8: JorgeCross5 (30679 in chips) 
rafinha.nr: posts the ante 125
LGPRENDES: posts the ante 125
flagao: posts the ante 125
beça07: posts the ante 125
JorgeCross5: posts the ante 125
JorgeCross5: posts small blind 500
rafinha.nr: posts big blind 1000
*** HOLE CARDS ***
Dealt to flagao [8s Kh]
LGPRENDES: folds 
flagao: raises 1000 to 2000
beça07: folds 
JorgeCross5: folds 
rafinha.nr: folds 
Uncalled bet (1000) returned to flagao
flagao collected 3125 from pot
flagao: doesn't show hand 
*** SUMMARY ***
Total pot 3125 | Rake 0 
Seat 2: rafinha.nr (big blind) folded before Flop
Seat 3: LGPRENDES folded before Flop (didn't bet)
Seat 6: flagao collected (3125)
Seat 7: beça07 (button) folded before Flop (didn't bet)
Seat 8: JorgeCross5 (small blind) folded before Flop



PokerStars Home Game Hand #211092302649: {Club #3217684} Tournament #2845705715, 17000+3000 Hold'em No Limit - Level XVII (500/1000) - 2020/03/31 23:38:57 ET
Table '2845705715 2' 9-max Seat #8 is the button
Seat 2: rafinha.nr (40215 in chips) 
Seat 3: LGPRENDES (21607 in chips) 
Seat 6: flagao (25555 in chips) 
Seat 7: beça07 (16031 in chips) 
Seat 8: JorgeCross5 (30054 in chips) 
rafinha.nr: posts the ante 125
LGPRENDES: posts the ante 125
flagao: posts the ante 125
beça07: posts the ante 125
JorgeCross5: posts the ante 125
rafinha.nr: posts small blind 500
LGPRENDES: posts big blind 1000
*** HOLE CARDS ***
Dealt to flagao [7d Ac]
flagao: folds 
beça07: folds 
JorgeCross5: folds 
rafinha.nr: folds 
Uncalled bet (500) returned to LGPRENDES
LGPRENDES collected 1625 from pot
LGPRENDES: doesn't show hand 
*** SUMMARY ***
Total pot 1625 | Rake 0 
Seat 2: rafinha.nr (small blind) folded before Flop
Seat 3: LGPRENDES (big blind) collected (1625)
Seat 6: flagao folded before Flop (didn't bet)
Seat 7: beça07 folded before Flop (didn't bet)
Seat 8: JorgeCross5 (button) folded before Flop (didn't bet)



PokerStars Home Game Hand #211092311546: {Club #3217684} Tournament #2845705715, 17000+3000 Hold'em No Limit - Level XVII (500/1000) - 2020/03/31 23:39:19 ET
Table '2845705715 2' 9-max Seat #2 is the button
Seat 2: rafinha.nr (39590 in chips) 
Seat 3: LGPRENDES (22607 in chips) 
Seat 6: flagao (25430 in chips) 
Seat 7: beça07 (15906 in chips) 
Seat 8: JorgeCross5 (29929 in chips) 
rafinha.nr: posts the ante 125
LGPRENDES: posts the ante 125
flagao: posts the ante 125
beça07: posts the ante 125
JorgeCross5: posts the ante 125
LGPRENDES: posts small blind 500
flagao: posts big blind 1000
*** HOLE CARDS ***
Dealt to flagao [2h Kc]
beça07: calls 1000
JorgeCross5: folds 
rafinha.nr: raises 3000 to 4000
LGPRENDES: folds 
flagao: folds 
beça07: folds 
Uncalled bet (3000) returned to rafinha.nr
rafinha.nr collected 4125 from pot
rafinha.nr: doesn't show hand 
*** SUMMARY ***
Total pot 4125 | Rake 0 
Seat 2: rafinha.nr (button) collected (4125)
Seat 3: LGPRENDES (small blind) folded before Flop
Seat 6: flagao (big blind) folded before Flop
Seat 7: beça07 folded before Flop
Seat 8: JorgeCross5 folded before Flop (didn't bet)



PokerStars Home Game Hand #211092321868: {Club #3217684} Tournament #2845705715, 17000+3000 Hold'em No Limit - Level XVII (500/1000) - 2020/03/31 23:39:44 ET
Table '2845705715 2' 9-max Seat #3 is the button
Seat 2: rafinha.nr (42590 in chips) 
Seat 3: LGPRENDES (21982 in chips) 
Seat 6: flagao (24305 in chips) 
Seat 7: beça07 (14781 in chips) 
Seat 8: JorgeCross5 (29804 in chips) 
rafinha.nr: posts the ante 125
LGPRENDES: posts the ante 125
flagao: posts the ante 125
beça07: posts the ante 125
JorgeCross5: posts the ante 125
flagao: posts small blind 500
beça07: posts big blind 1000
*** HOLE CARDS ***
Dealt to flagao [Qs 4c]
JorgeCross5: calls 1000
rafinha.nr: folds 
LGPRENDES: folds 
flagao: folds 
beça07: checks 
*** FLOP *** [3c Kd 5h]
beça07: checks 
JorgeCross5: bets 14000
beça07: folds 
Uncalled bet (14000) returned to JorgeCross5
JorgeCross5 collected 3125 from pot
JorgeCross5: doesn't show hand 
*** SUMMARY ***
Total pot 3125 | Rake 0 
Board [3c Kd 5h]
Seat 2: rafinha.nr folded before Flop (didn't bet)
Seat 3: LGPRENDES (button) folded before Flop (didn't bet)
Seat 6: flagao (small blind) folded before Flop
Seat 7: beça07 (big blind) folded on the Flop
Seat 8: JorgeCross5 collected (3125)



PokerStars Home Game Hand #211092335677: {Club #3217684} Tournament #2845705715, 17000+3000 Hold'em No Limit - Level XVII (500/1000) - 2020/03/31 23:40:17 ET
Table '2845705715 2' 9-max Seat #6 is the button
Seat 2: rafinha.nr (42465 in chips) 
Seat 3: LGPRENDES (21857 in chips) 
Seat 6: flagao (23680 in chips) 
Seat 7: beça07 (13656 in chips) 
Seat 8: JorgeCross5 (31804 in chips) 
rafinha.nr: posts the ante 125
LGPRENDES: posts the ante 125
flagao: posts the ante 125
beça07: posts the ante 125
JorgeCross5: posts the ante 125
beça07: posts small blind 500
JorgeCross5: posts big blind 1000
*** HOLE CARDS ***
Dealt to flagao [Ad 7s]
rafinha.nr: folds 
LGPRENDES: folds 
flagao: raises 1000 to 2000
beça07: folds 
JorgeCross5: calls 1000
*** FLOP *** [6d Ah 3s]
JorgeCross5: checks 
flagao: bets 2155
JorgeCross5: folds 
Uncalled bet (2155) returned to flagao
flagao collected 5125 from pot
flagao: doesn't show hand 
*** SUMMARY ***
Total pot 5125 | Rake 0 
Board [6d Ah 3s]
Seat 2: rafinha.nr folded before Flop (didn't bet)
Seat 3: LGPRENDES folded before Flop (didn't bet)
Seat 6: flagao (button) collected (5125)
Seat 7: beça07 (small blind) folded before Flop
Seat 8: JorgeCross5 (big blind) folded on the Flop



PokerStars Home Game Hand #211092353517: {Club #3217684} Tournament #2845705715, 17000+3000 Hold'em No Limit - Level XVII (500/1000) - 2020/03/31 23:41:00 ET
Table '2845705715 2' 9-max Seat #7 is the button
Seat 2: rafinha.nr (42340 in chips) 
Seat 3: LGPRENDES (21732 in chips) 
Seat 6: flagao (26680 in chips) 
Seat 7: beça07 (13031 in chips) 
Seat 8: JorgeCross5 (29679 in chips) 
rafinha.nr: posts the ante 125
LGPRENDES: posts the ante 125
flagao: posts the ante 125
beça07: posts the ante 125
JorgeCross5: posts the ante 125
JorgeCross5: posts small blind 500
rafinha.nr: posts big blind 1000
*** HOLE CARDS ***
Dealt to flagao [Kh Qd]
LGPRENDES: folds 
flagao: raises 1000 to 2000
beça07: raises 10906 to 12906 and is all-in
JorgeCross5: folds 
rafinha.nr: folds 
flagao: folds 
Uncalled bet (10906) returned to beça07
beça07 collected 6125 from pot
beça07: doesn't show hand 
*** SUMMARY ***
Total pot 6125 | Rake 0 
Seat 2: rafinha.nr (big blind) folded before Flop
Seat 3: LGPRENDES folded before Flop (didn't bet)
Seat 6: flagao folded before Flop
Seat 7: beça07 (button) collected (6125)
Seat 8: JorgeCross5 (small blind) folded before Flop



PokerStars Home Game Hand #211092364749: {Club #3217684} Tournament #2845705715, 17000+3000 Hold'em No Limit - Level XVII (500/1000) - 2020/03/31 23:41:27 ET
Table '2845705715 2' 9-max Seat #8 is the button
Seat 2: rafinha.nr (41215 in chips) 
Seat 3: LGPRENDES (21607 in chips) 
Seat 6: flagao (24555 in chips) 
Seat 7: beça07 (17031 in chips) 
Seat 8: JorgeCross5 (29054 in chips) 
rafinha.nr: posts the ante 125
LGPRENDES: posts the ante 125
flagao: posts the ante 125
beça07: posts the ante 125
JorgeCross5: posts the ante 125
rafinha.nr: posts small blind 500
LGPRENDES: posts big blind 1000
*** HOLE CARDS ***
Dealt to flagao [7d 3d]
flagao: folds 
beça07: folds 
JorgeCross5: calls 1000
rafinha.nr: calls 500
LGPRENDES: checks 
*** FLOP *** [6h Jd Tc]
rafinha.nr: checks 
LGPRENDES: bets 1000
JorgeCross5: calls 1000
rafinha.nr: calls 1000
*** TURN *** [6h Jd Tc] [3h]
rafinha.nr: checks 
LGPRENDES: bets 3000
JorgeCross5: calls 3000
rafinha.nr: folds 
*** RIVER *** [6h Jd Tc 3h] [Kc]
LGPRENDES: checks 
JorgeCross5: checks 
*** SHOW DOWN ***
LGPRENDES: shows [Js 3s] (two pair, Jacks and Threes)
JorgeCross5: mucks hand 
LGPRENDES collected 12625 from pot
*** SUMMARY ***
Total pot 12625 | Rake 0 
Board [6h Jd Tc 3h Kc]
Seat 2: rafinha.nr (small blind) folded on the Turn
Seat 3: LGPRENDES (big blind) showed [Js 3s] and won (12625) with two pair, Jacks and Threes
Seat 6: flagao folded before Flop (didn't bet)
Seat 7: beça07 folded before Flop (didn't bet)
Seat 8: JorgeCross5 (button) mucked [9s Kh]



PokerStars Home Game Hand #211092395191: {Club #3217684} Tournament #2845705715, 17000+3000 Hold'em No Limit - Level XVII (500/1000) - 2020/03/31 23:42:27 ET
Table '2845705715 2' 9-max Seat #2 is the button
Seat 2: rafinha.nr (39090 in chips) 
Seat 3: LGPRENDES (29107 in chips) 
Seat 6: flagao (24430 in chips) 
Seat 7: beça07 (16906 in chips) 
Seat 8: JorgeCross5 (23929 in chips) 
rafinha.nr: posts the ante 125
LGPRENDES: posts the ante 125
flagao: posts the ante 125
beça07: posts the ante 125
JorgeCross5: posts the ante 125
LGPRENDES: posts small blind 500
flagao: posts big blind 1000
*** HOLE CARDS ***
Dealt to flagao [5c Jh]
beça07: folds 
JorgeCross5: folds 
rafinha.nr: folds 
LGPRENDES: raises 1000 to 2000
flagao: folds 
Uncalled bet (1000) returned to LGPRENDES
LGPRENDES collected 2625 from pot
LGPRENDES: doesn't show hand 
*** SUMMARY ***
Total pot 2625 | Rake 0 
Seat 2: rafinha.nr (button) folded before Flop (didn't bet)
Seat 3: LGPRENDES (small blind) collected (2625)
Seat 6: flagao (big blind) folded before Flop
Seat 7: beça07 folded before Flop (didn't bet)
Seat 8: JorgeCross5 folded before Flop (didn't bet)



PokerStars Home Game Hand #211092406717: {Club #3217684} Tournament #2845705715, 17000+3000 Hold'em No Limit - Level XVII (500/1000) - 2020/03/31 23:42:55 ET
Table '2845705715 2' 9-max Seat #3 is the button
Seat 2: rafinha.nr (38965 in chips) 
Seat 3: LGPRENDES (30607 in chips) 
Seat 6: flagao (23305 in chips) 
Seat 7: beça07 (16781 in chips) 
Seat 8: JorgeCross5 (23804 in chips) 
rafinha.nr: posts the ante 125
LGPRENDES: posts the ante 125
flagao: posts the ante 125
beça07: posts the ante 125
JorgeCross5: posts the ante 125
flagao: posts small blind 500
beça07: posts big blind 1000
*** HOLE CARDS ***
Dealt to flagao [Jh Kc]
JorgeCross5: folds 
rafinha.nr: folds 
LGPRENDES: calls 1000
flagao: raises 1500 to 2500
beça07: calls 1500
LGPRENDES: calls 1500
*** FLOP *** [Js Kh 7s]
LA_nds08 said, "Mao de bater em padre"
flagao: bets 2500
beça07: calls 2500
LGPRENDES: folds 
*** TURN *** [Js Kh 7s] [6d]
SBocha said, "hahahahaha"
flagao: bets 4000
beça07: calls 4000
*** RIVER *** [Js Kh 7s 6d] [2c]
flagao: bets 14180 and is all-in
beça07: calls 7656 and is all-in
Uncalled bet (6524) returned to flagao
*** SHOW DOWN ***
flagao: shows [Jh Kc] (two pair, Kings and Jacks)
beça07: shows [Kd Qh] (a pair of Kings)
flagao collected 36437 from pot
*** SUMMARY ***
Total pot 36437 | Rake 0 
Board [Js Kh 7s 6d 2c]
Seat 2: rafinha.nr folded before Flop (didn't bet)
Seat 3: LGPRENDES (button) folded on the Flop
Seat 6: flagao (small blind) showed [Jh Kc] and won (36437) with two pair, Kings and Jacks
Seat 7: beça07 (big blind) showed [Kd Qh] and lost with a pair of Kings
Seat 8: JorgeCross5 folded before Flop (didn't bet)



PokerStars Home Game Hand #211092438611: {Club #3217684} Tournament #2845705715, 17000+3000 Hold'em No Limit - Level XVII (500/1000) - 2020/03/31 23:44:14 ET
Table '2845705715 2' 9-max Seat #6 is the button
Seat 1: Messi_br (39906 in chips) 
Seat 2: rafinha.nr (38840 in chips) 
Seat 3: LGPRENDES (27982 in chips) 
Seat 4: kinnho007 (24420 in chips) 
Seat 5: LA_nds08 (61039 in chips) 
Seat 6: flagao (42961 in chips) 
Seat 8: JorgeCross5 (23679 in chips) 
Seat 9: SBocha (21173 in chips) 
Messi_br: posts the ante 125
rafinha.nr: posts the ante 125
LGPRENDES: posts the ante 125
kinnho007: posts the ante 125
LA_nds08: posts the ante 125
flagao: posts the ante 125
JorgeCross5: posts the ante 125
SBocha: posts the ante 125
JorgeCross5: posts small blind 500
SBocha: posts big blind 1000
*** HOLE CARDS ***
Dealt to flagao [Ad 3s]
Messi_br: folds 
rafinha.nr: calls 1000
LGPRENDES: folds 
kinnho007: folds 
LA_nds08: calls 1000
flagao: folds 
JorgeCross5: folds 
SBocha: checks 
*** FLOP *** [5d Th Tc]
SBocha: checks 
rafinha.nr: checks 
LA_nds08: checks 
*** TURN *** [5d Th Tc] [Jh]
SBocha: checks 
rafinha.nr: checks 
LA_nds08: checks 
*** RIVER *** [5d Th Tc Jh] [9h]
SBocha: checks 
rafinha.nr: checks 
LA_nds08: checks 
*** SHOW DOWN ***
SBocha: shows [Kd 8h] (a pair of Tens)
rafinha.nr: shows [9c Ks] (two pair, Tens and Nines)
LA_nds08: mucks hand 
rafinha.nr collected 4500 from pot
*** SUMMARY ***
Total pot 4500 | Rake 0 
Board [5d Th Tc Jh 9h]
Seat 1: Messi_br folded before Flop (didn't bet)
Seat 2: rafinha.nr showed [9c Ks] and won (4500) with two pair, Tens and Nines
Seat 3: LGPRENDES folded before Flop (didn't bet)
Seat 4: kinnho007 folded before Flop (didn't bet)
Seat 5: LA_nds08 mucked [2s 2c]
Seat 6: flagao (button) folded before Flop (didn't bet)
Seat 8: JorgeCross5 (small blind) folded before Flop
Seat 9: SBocha (big blind) showed [Kd 8h] and lost with a pair of Tens



PokerStars Home Game Hand #211092463281: {Club #3217684} Tournament #2845705715, 17000+3000 Hold'em No Limit - Level XVIII (600/1200) - 2020/03/31 23:45:14 ET
Table '2845705715 2' 9-max Seat #8 is the button
Seat 1: Messi_br (39781 in chips) 
Seat 2: rafinha.nr (42215 in chips) 
Seat 3: LGPRENDES (27857 in chips) 
Seat 4: kinnho007 (24295 in chips) 
Seat 5: LA_nds08 (59914 in chips) 
Seat 6: flagao (42836 in chips) 
Seat 8: JorgeCross5 (23054 in chips) 
Seat 9: SBocha (20048 in chips) 
Messi_br: posts the ante 150
rafinha.nr: posts the ante 150
LGPRENDES: posts the ante 150
kinnho007: posts the ante 150
LA_nds08: posts the ante 150
flagao: posts the ante 150
JorgeCross5: posts the ante 150
SBocha: posts the ante 150
SBocha: posts small blind 600
Messi_br: posts big blind 1200
*** HOLE CARDS ***
Dealt to flagao [4c Jd]
rafinha.nr: raises 3800 to 5000
LGPRENDES: folds 
kinnho007: folds 
LA_nds08: folds 
flagao: folds 
JorgeCross5: folds 
SBocha: folds 
Messi_br: calls 3800
*** FLOP *** [7d 4h Kd]
Messi_br: checks 
rafinha.nr: bets 5000
Messi_br: calls 5000
*** TURN *** [7d 4h Kd] [6h]
Messi_br: checks 
rafinha.nr: bets 32065 and is all-in
Messi_br: folds [Ah]
Uncalled bet (32065) returned to rafinha.nr
rafinha.nr collected 21800 from pot
rafinha.nr: doesn't show hand 
*** SUMMARY ***
Total pot 21800 | Rake 0 
Board [7d 4h Kd 6h]
Seat 1: Messi_br (big blind) folded on the Turn
Seat 2: rafinha.nr collected (21800)
Seat 3: LGPRENDES folded before Flop (didn't bet)
Seat 4: kinnho007 folded before Flop (didn't bet)
Seat 5: LA_nds08 folded before Flop (didn't bet)
Seat 6: flagao folded before Flop (didn't bet)
Seat 8: JorgeCross5 (button) folded before Flop (didn't bet)
Seat 9: SBocha (small blind) folded before Flop



PokerStars Home Game Hand #211092504774: {Club #3217684} Tournament #2845705715, 17000+3000 Hold'em No Limit - Level XVIII (600/1200) - 2020/03/31 23:46:42 ET
Table '2845705715 2' 9-max Seat #9 is the button
Seat 1: Messi_br (29631 in chips) 
Seat 2: rafinha.nr (53865 in chips) 
Seat 3: LGPRENDES (27707 in chips) 
Seat 4: kinnho007 (24145 in chips) 
Seat 5: LA_nds08 (59764 in chips) 
Seat 6: flagao (42686 in chips) 
Seat 8: JorgeCross5 (22904 in chips) 
Seat 9: SBocha (19298 in chips) 
Messi_br: posts the ante 150
rafinha.nr: posts the ante 150
LGPRENDES: posts the ante 150
kinnho007: posts the ante 150
LA_nds08: posts the ante 150
flagao: posts the ante 150
JorgeCross5: posts the ante 150
SBocha: posts the ante 150
Messi_br: posts small blind 600
rafinha.nr: posts big blind 1200
*** HOLE CARDS ***
Dealt to flagao [Kd Ah]
rafinha.nr said, "1010"
LGPRENDES: calls 1200
kinnho007: folds 
LA_nds08: folds 
flagao: raises 2400 to 3600
JorgeCross5: folds 
SBocha: folds 
Messi_br: folds 
rafinha.nr: folds 
LGPRENDES: folds 
Uncalled bet (2400) returned to flagao
flagao collected 5400 from pot
flagao: doesn't show hand 
*** SUMMARY ***
Total pot 5400 | Rake 0 
Seat 1: Messi_br (small blind) folded before Flop
Seat 2: rafinha.nr (big blind) folded before Flop
Seat 3: LGPRENDES folded before Flop
Seat 4: kinnho007 folded before Flop (didn't bet)
Seat 5: LA_nds08 folded before Flop (didn't bet)
Seat 6: flagao collected (5400)
Seat 8: JorgeCross5 folded before Flop (didn't bet)
Seat 9: SBocha (button) folded before Flop (didn't bet)



PokerStars Home Game Hand #211092516848: {Club #3217684} Tournament #2845705715, 17000+3000 Hold'em No Limit - Level XVIII (600/1200) - 2020/03/31 23:47:12 ET
Table '2845705715 2' 9-max Seat #1 is the button
Seat 1: Messi_br (28881 in chips) 
Seat 2: rafinha.nr (52515 in chips) 
Seat 3: LGPRENDES (26357 in chips) 
Seat 4: kinnho007 (23995 in chips) 
Seat 5: LA_nds08 (59614 in chips) 
Seat 6: flagao (46736 in chips) 
Seat 8: JorgeCross5 (22754 in chips) 
Seat 9: SBocha (19148 in chips) 
Messi_br: posts the ante 150
rafinha.nr: posts the ante 150
LGPRENDES: posts the ante 150
kinnho007: posts the ante 150
LA_nds08: posts the ante 150
flagao: posts the ante 150
JorgeCross5: posts the ante 150
SBocha: posts the ante 150
rafinha.nr: posts small blind 600
LGPRENDES: posts big blind 1200
*** HOLE CARDS ***
Dealt to flagao [9c 2d]
kinnho007: folds 
LA_nds08: folds 
flagao: folds 
JorgeCross5: folds 
SBocha: folds 
Messi_br: calls 1200
rafinha.nr: raises 1800 to 3000
LGPRENDES: calls 1800
Messi_br: calls 1800
*** FLOP *** [7c Qs Ks]
rafinha.nr: bets 6000
LGPRENDES: calls 6000
Messi_br: raises 6000 to 12000
rafinha.nr: calls 6000
LGPRENDES: raises 11207 to 23207 and is all-in
Messi_br: folds 
rafinha.nr: folds 
Uncalled bet (11207) returned to LGPRENDES
LGPRENDES collected 46200 from pot
LGPRENDES: doesn't show hand 
*** SUMMARY ***
Total pot 46200 | Rake 0 
Board [7c Qs Ks]
Seat 1: Messi_br (button) folded on the Flop
Seat 2: rafinha.nr (small blind) folded on the Flop
Seat 3: LGPRENDES (big blind) collected (46200)
Seat 4: kinnho007 folded before Flop (didn't bet)
Seat 5: LA_nds08 folded before Flop (didn't bet)
Seat 6: flagao folded before Flop (didn't bet)
Seat 8: JorgeCross5 folded before Flop (didn't bet)
Seat 9: SBocha folded before Flop (didn't bet)



PokerStars Home Game Hand #211092551410: {Club #3217684} Tournament #2845705715, 17000+3000 Hold'em No Limit - Level XVIII (600/1200) - 2020/03/31 23:48:38 ET
Table '2845705715 2' 9-max Seat #2 is the button
Seat 1: Messi_br (13731 in chips) 
Seat 2: rafinha.nr (37365 in chips) 
Seat 3: LGPRENDES (57407 in chips) 
Seat 4: kinnho007 (23845 in chips) 
Seat 5: LA_nds08 (59464 in chips) 
Seat 6: flagao (46586 in chips) 
Seat 8: JorgeCross5 (22604 in chips) 
Seat 9: SBocha (18998 in chips) 
Messi_br: posts the ante 150
rafinha.nr: posts the ante 150
LGPRENDES: posts the ante 150
kinnho007: posts the ante 150
LA_nds08: posts the ante 150
flagao: posts the ante 150
JorgeCross5: posts the ante 150
SBocha: posts the ante 150
LGPRENDES: posts small blind 600
kinnho007: posts big blind 1200
*** HOLE CARDS ***
Dealt to flagao [3h 3d]
flagao said, "AK Gabriel?"
rafinha.nr said, "tava nao fe"
LA_nds08: folds 
flagao: raises 1200 to 2400
JorgeCross5: folds 
SBocha: folds 
Messi_br: folds 
rafinha.nr said, "KJ"
rafinha.nr: calls 2400
LGPRENDES: folds 
kinnho007: calls 1200
*** FLOP *** [8c Jh 2s]
kinnho007: checks 
flagao: checks 
rafinha.nr: bets 2400
kinnho007: folds 
flagao: folds 
Uncalled bet (2400) returned to rafinha.nr
rafinha.nr collected 9000 from pot
rafinha.nr: doesn't show hand 
*** SUMMARY ***
Total pot 9000 | Rake 0 
Board [8c Jh 2s]
Seat 1: Messi_br folded before Flop (didn't bet)
Seat 2: rafinha.nr (button) collected (9000)
Seat 3: LGPRENDES (small blind) folded before Flop
Seat 4: kinnho007 (big blind) folded on the Flop
Seat 5: LA_nds08 folded before Flop (didn't bet)
Seat 6: flagao folded on the Flop
Seat 8: JorgeCross5 folded before Flop (didn't bet)
Seat 9: SBocha folded before Flop (didn't bet)



PokerStars Home Game Hand #211092576570: {Club #3217684} Tournament #2845705715, 17000+3000 Hold'em No Limit - Level XVIII (600/1200) - 2020/03/31 23:49:40 ET
Table '2845705715 2' 9-max Seat #3 is the button
Seat 1: Messi_br (13581 in chips) 
Seat 2: rafinha.nr (43815 in chips) 
Seat 3: LGPRENDES (56657 in chips) 
Seat 4: kinnho007 (21295 in chips) 
Seat 5: LA_nds08 (59314 in chips) 
Seat 6: flagao (44036 in chips) 
Seat 8: JorgeCross5 (22454 in chips) 
Seat 9: SBocha (18848 in chips) 
Messi_br: posts the ante 150
rafinha.nr: posts the ante 150
LGPRENDES: posts the ante 150
kinnho007: posts the ante 150
LA_nds08: posts the ante 150
flagao: posts the ante 150
JorgeCross5: posts the ante 150
SBocha: posts the ante 150
kinnho007: posts small blind 600
LA_nds08: posts big blind 1200
*** HOLE CARDS ***
Dealt to flagao [Qc 5s]
flagao: folds 
JorgeCross5: folds 
SBocha: folds 
Messi_br: calls 1200
rafinha.nr: folds 
LGPRENDES: folds 
kinnho007: calls 600
LA_nds08: raises 3600 to 4800
Messi_br: calls 3600
kinnho007: calls 3600
*** FLOP *** [Tc 2d 9c]
kinnho007: checks 
LA_nds08: bets 7200
Messi_br: folds 
Messi_br said, "a7"
kinnho007: calls 7200
*** TURN *** [Tc 2d 9c] [Td]
kinnho007: bets 9145 and is all-in
LA_nds08: calls 9145
*** RIVER *** [Tc 2d 9c Td] [As]
*** SHOW DOWN ***
kinnho007: shows [Ac 9d] (two pair, Aces and Tens)
LA_nds08: shows [Kd Kh] (two pair, Kings and Tens)
kinnho007 collected 48290 from pot
*** SUMMARY ***
Total pot 48290 | Rake 0 
Board [Tc 2d 9c Td As]
Seat 1: Messi_br folded on the Flop
Seat 2: rafinha.nr folded before Flop (didn't bet)
Seat 3: LGPRENDES (button) folded before Flop (didn't bet)
Seat 4: kinnho007 (small blind) showed [Ac 9d] and won (48290) with two pair, Aces and Tens
Seat 5: LA_nds08 (big blind) showed [Kd Kh] and lost with two pair, Kings and Tens
Seat 6: flagao folded before Flop (didn't bet)
Seat 8: JorgeCross5 folded before Flop (didn't bet)
Seat 9: SBocha folded before Flop (didn't bet)



PokerStars Home Game Hand #211092614441: {Club #3217684} Tournament #2845705715, 17000+3000 Hold'em No Limit - Level XVIII (600/1200) - 2020/03/31 23:50:58 ET
Table '2845705715 2' 9-max Seat #4 is the button
Seat 1: Messi_br (8631 in chips) 
Seat 2: rafinha.nr (43665 in chips) 
Seat 3: LGPRENDES (56507 in chips) 
Seat 4: kinnho007 (48290 in chips) 
Seat 5: LA_nds08 (38019 in chips) 
Seat 6: flagao (43886 in chips) 
Seat 8: JorgeCross5 (22304 in chips) 
Seat 9: SBocha (18698 in chips) 
Messi_br: posts the ante 150
rafinha.nr: posts the ante 150
LGPRENDES: posts the ante 150
kinnho007: posts the ante 150
LA_nds08: posts the ante 150
flagao: posts the ante 150
JorgeCross5: posts the ante 150
SBocha: posts the ante 150
LA_nds08: posts small blind 600
flagao: posts big blind 1200
*** HOLE CARDS ***
Dealt to flagao [4h 8h]
flagao said, "Ahhhhhhh"
SBocha said, "mao que bate em padre"
kinnho007 said, "ufaaaaaaa"
JorgeCross5: calls 1200
SBocha: calls 1200
kinnho007 said, "kkkkkk"
Messi_br: raises 7281 to 8481 and is all-in
rafinha.nr: folds 
LGPRENDES: folds 
kinnho007: folds 
LA_nds08: folds 
flagao: folds 
JorgeCross5: calls 7281
SBocha: folds 
*** FLOP *** [4d 5d 9s]
*** TURN *** [4d 5d 9s] [4s]
*** RIVER *** [4d 5d 9s 4s] [3c]
*** SHOW DOWN ***
JorgeCross5: shows [9h Kh] (two pair, Nines and Fours)
Messi_br: shows [Qh Js] (a pair of Fours)
JorgeCross5 collected 21162 from pot
Messi_br finished the tournament in 8th place
*** SUMMARY ***
Total pot 21162 | Rake 0 
Board [4d 5d 9s 4s 3c]
Seat 1: Messi_br showed [Qh Js] and lost with a pair of Fours
Seat 2: rafinha.nr folded before Flop (didn't bet)
Seat 3: LGPRENDES folded before Flop (didn't bet)
Seat 4: kinnho007 (button) folded before Flop (didn't bet)
Seat 5: LA_nds08 (small blind) folded before Flop
Seat 6: flagao (big blind) folded before Flop
Seat 8: JorgeCross5 showed [9h Kh] and won (21162) with two pair, Nines and Fours
Seat 9: SBocha folded before Flop



PokerStars Home Game Hand #211092638241: {Club #3217684} Tournament #2845705715, 17000+3000 Hold'em No Limit - Level XVIII (600/1200) - 2020/03/31 23:51:58 ET
Table '2845705715 2' 9-max Seat #5 is the button
Seat 2: rafinha.nr (43515 in chips) 
Seat 3: LGPRENDES (56357 in chips) 
Seat 4: kinnho007 (48140 in chips) 
Seat 5: LA_nds08 (37269 in chips) 
Seat 6: flagao (42536 in chips) 
Seat 8: JorgeCross5 (34835 in chips) 
Seat 9: SBocha (17348 in chips) 
rafinha.nr: posts the ante 150
LGPRENDES: posts the ante 150
kinnho007: posts the ante 150
LA_nds08: posts the ante 150
flagao: posts the ante 150
JorgeCross5: posts the ante 150
SBocha: posts the ante 150
flagao: posts small blind 600
JorgeCross5: posts big blind 1200
*** HOLE CARDS ***
Dealt to flagao [Jh Th]
SBocha: folds 
rafinha.nr: folds 
SBocha said, "eu tinha a mao que bate em padre e foldei"
LGPRENDES: folds 
kinnho007: folds 
LA_nds08: raises 1200 to 2400
flagao: calls 1800
JorgeCross5: folds 
*** FLOP *** [6h 5s 9c]
flagao: bets 2400
LA_nds08: calls 2400
*** TURN *** [6h 5s 9c] [8h]
flagao: bets 3600
LA_nds08: calls 3600
*** RIVER *** [6h 5s 9c 8h] [4h]
flagao: checks 
LA_nds08: checks 
*** SHOW DOWN ***
flagao: shows [Jh Th] (a flush, Jack high)
LA_nds08: mucks hand 
flagao collected 19050 from pot
*** SUMMARY ***
Total pot 19050 | Rake 0 
Board [6h 5s 9c 8h 4h]
Seat 2: rafinha.nr folded before Flop (didn't bet)
Seat 3: LGPRENDES folded before Flop (didn't bet)
Seat 4: kinnho007 folded before Flop (didn't bet)
Seat 5: LA_nds08 (button) mucked [Ks 7c]
Seat 6: flagao (small blind) showed [Jh Th] and won (19050) with a flush, Jack high
Seat 8: JorgeCross5 (big blind) folded before Flop
Seat 9: SBocha folded before Flop (didn't bet)



PokerStars Home Game Hand #211092667027: {Club #3217684} Tournament #2845705715, 17000+3000 Hold'em No Limit - Level XVIII (600/1200) - 2020/03/31 23:53:11 ET
Table '2845705715 2' 9-max Seat #6 is the button
Seat 2: rafinha.nr (43365 in chips) 
Seat 3: LGPRENDES (56207 in chips) 
Seat 4: kinnho007 (47990 in chips) 
Seat 5: LA_nds08 (28719 in chips) 
Seat 6: flagao (53036 in chips) 
Seat 8: JorgeCross5 (33485 in chips) 
Seat 9: SBocha (17198 in chips) 
rafinha.nr: posts the ante 150
LGPRENDES: posts the ante 150
kinnho007: posts the ante 150
LA_nds08: posts the ante 150
flagao: posts the ante 150
JorgeCross5: posts the ante 150
SBocha: posts the ante 150
JorgeCross5: posts small blind 600
SBocha: posts big blind 1200
*** HOLE CARDS ***
Dealt to flagao [Th 4d]
flagao said, "Ahhhhhhh"
rafinha.nr: folds 
LGPRENDES: raises 1200 to 2400
kinnho007: folds 
LA_nds08: folds 
flagao: folds 
JorgeCross5: folds 
LA_nds08 said, "riveres crueis"
SBocha: calls 1200
*** FLOP *** [Td Tc 4s]
SBocha: checks 
LGPRENDES: bets 3600
SBocha: folds 
Uncalled bet (3600) returned to LGPRENDES
LGPRENDES collected 6450 from pot
LGPRENDES: doesn't show hand 
*** SUMMARY ***
Total pot 6450 | Rake 0 
Board [Td Tc 4s]
Seat 2: rafinha.nr folded before Flop (didn't bet)
Seat 3: LGPRENDES collected (6450)
Seat 4: kinnho007 folded before Flop (didn't bet)
Seat 5: LA_nds08 folded before Flop (didn't bet)
Seat 6: flagao (button) folded before Flop (didn't bet)
Seat 8: JorgeCross5 (small blind) folded before Flop
Seat 9: SBocha (big blind) folded on the Flop



PokerStars Home Game Hand #211092686896: {Club #3217684} Tournament #2845705715, 17000+3000 Hold'em No Limit - Level XVIII (600/1200) - 2020/03/31 23:54:01 ET
Table '2845705715 2' 9-max Seat #8 is the button
Seat 2: rafinha.nr (43215 in chips) 
Seat 3: LGPRENDES (60107 in chips) 
Seat 4: kinnho007 (47840 in chips) 
Seat 5: LA_nds08 (28569 in chips) 
Seat 6: flagao (52886 in chips) 
Seat 8: JorgeCross5 (32735 in chips) 
Seat 9: SBocha (14648 in chips) 
rafinha.nr: posts the ante 150
LGPRENDES: posts the ante 150
kinnho007: posts the ante 150
LA_nds08: posts the ante 150
flagao: posts the ante 150
JorgeCross5: posts the ante 150
SBocha: posts the ante 150
SBocha: posts small blind 600
rafinha.nr: posts big blind 1200
*** HOLE CARDS ***
Dealt to flagao [Kd Kh]
LGPRENDES: folds 
kinnho007: folds 
LA_nds08: folds 
flagao: raises 1200 to 2400
JorgeCross5: folds 
SBocha: raises 12098 to 14498 and is all-in
rafinha.nr: folds 
flagao: calls 12098
*** FLOP *** [5h 7c Kc]
*** TURN *** [5h 7c Kc] [9d]
rafinha.nr said, "vixi"
*** RIVER *** [5h 7c Kc 9d] [8d]
*** SHOW DOWN ***
SBocha: shows [Ac Qd] (high card Ace)
flagao: shows [Kd Kh] (three of a kind, Kings)
flagao collected 31246 from pot
SBocha finished the tournament in 7th place
*** SUMMARY ***
Total pot 31246 | Rake 0 
Board [5h 7c Kc 9d 8d]
Seat 2: rafinha.nr (big blind) folded before Flop
Seat 3: LGPRENDES folded before Flop (didn't bet)
Seat 4: kinnho007 folded before Flop (didn't bet)
Seat 5: LA_nds08 folded before Flop (didn't bet)
Seat 6: flagao showed [Kd Kh] and won (31246) with three of a kind, Kings
Seat 8: JorgeCross5 (button) folded before Flop (didn't bet)
Seat 9: SBocha (small blind) showed [Ac Qd] and lost with high card Ace



PokerStars Home Game Hand #211092701409: {Club #3217684} Tournament #2845705715, 17000+3000 Hold'em No Limit - Level XVIII (600/1200) - 2020/03/31 23:54:37 ET
Table '2845705715 2' 9-max Seat #2 is the button
Seat 2: rafinha.nr (41865 in chips) 
Seat 3: LGPRENDES (59957 in chips) 
Seat 4: kinnho007 (47690 in chips) 
Seat 5: LA_nds08 (28419 in chips) 
Seat 6: flagao (69484 in chips) 
Seat 8: JorgeCross5 (32585 in chips) 
rafinha.nr: posts the ante 150
LGPRENDES: posts the ante 150
kinnho007: posts the ante 150
LA_nds08: posts the ante 150
flagao: posts the ante 150
JorgeCross5: posts the ante 150
LGPRENDES: posts small blind 600
kinnho007: posts big blind 1200
*** HOLE CARDS ***
Dealt to flagao [2s 8c]
LA_nds08: folds 
flagao: folds 
rafinha.nr said, "flagao gigante"
JorgeCross5: calls 1200
rafinha.nr said, "literalmete"
rafinha.nr: raises 2000 to 3200
LGPRENDES: folds 
kinnho007: calls 2000
JorgeCross5: calls 2000
*** FLOP *** [Ts 9s 9c]
kinnho007: checks 
JorgeCross5: checks 
rafinha.nr: checks 
*** TURN *** [Ts 9s 9c] [3s]
kinnho007: checks 
JorgeCross5: checks 
rafinha.nr: checks 
*** RIVER *** [Ts 9s 9c 3s] [9h]
kinnho007: bets 1200
JorgeCross5: folds 
rafinha.nr: calls 1200
*** SHOW DOWN ***
kinnho007: shows [Qc Jc] (three of a kind, Nines)
rafinha.nr: shows [Ad 2d] (three of a kind, Nines - Ace kicker)
rafinha.nr collected 13500 from pot
*** SUMMARY ***
Total pot 13500 | Rake 0 
Board [Ts 9s 9c 3s 9h]
Seat 2: rafinha.nr (button) showed [Ad 2d] and won (13500) with three of a kind, Nines
Seat 3: LGPRENDES (small blind) folded before Flop
Seat 4: kinnho007 (big blind) showed [Qc Jc] and lost with three of a kind, Nines
Seat 5: LA_nds08 folded before Flop (didn't bet)
Seat 6: flagao folded before Flop (didn't bet)
Seat 8: JorgeCross5 folded on the River



PokerStars Home Game Hand #211092829116: {Club #3217684} Tournament #2845705715, 17000+3000 Hold'em No Limit - Level XIX (700/1400) - 2020/04/01 0:00:51 ET
Table '2845705715 2' 9-max Seat #3 is the button
Seat 2: rafinha.nr (50815 in chips) 
Seat 3: LGPRENDES (59207 in chips) 
Seat 4: kinnho007 (43140 in chips) 
Seat 5: LA_nds08 (28269 in chips) 
Seat 6: flagao (69334 in chips) 
Seat 8: JorgeCross5 (29235 in chips) 
rafinha.nr: posts the ante 175
LGPRENDES: posts the ante 175
kinnho007: posts the ante 175
LA_nds08: posts the ante 175
flagao: posts the ante 175
JorgeCross5: posts the ante 175
kinnho007: posts small blind 700
LA_nds08: posts big blind 1400
*** HOLE CARDS ***
Dealt to flagao [Jh 3d]
flagao: folds 
JorgeCross5: folds 
rafinha.nr: folds 
LGPRENDES: folds 
kinnho007: calls 700
LA_nds08: checks 
*** FLOP *** [Ad 2h 9d]
kinnho007: bets 1400
LA_nds08: folds 
Uncalled bet (1400) returned to kinnho007
kinnho007 collected 3850 from pot
kinnho007: doesn't show hand 
*** SUMMARY ***
Total pot 3850 | Rake 0 
Board [Ad 2h 9d]
Seat 2: rafinha.nr folded before Flop (didn't bet)
Seat 3: LGPRENDES (button) folded before Flop (didn't bet)
Seat 4: kinnho007 (small blind) collected (3850)
Seat 5: LA_nds08 (big blind) folded on the Flop
Seat 6: flagao folded before Flop (didn't bet)
Seat 8: JorgeCross5 folded before Flop (didn't bet)



PokerStars Home Game Hand #211092848825: {Club #3217684} Tournament #2845705715, 17000+3000 Hold'em No Limit - Level XIX (700/1400) - 2020/04/01 0:01:44 ET
Table '2845705715 2' 9-max Seat #4 is the button
Seat 2: rafinha.nr (50640 in chips) 
Seat 3: LGPRENDES (59032 in chips) 
Seat 4: kinnho007 (45415 in chips) 
Seat 5: LA_nds08 (26694 in chips) 
Seat 6: flagao (69159 in chips) 
Seat 8: JorgeCross5 (29060 in chips) 
rafinha.nr: posts the ante 175
LGPRENDES: posts the ante 175
kinnho007: posts the ante 175
LA_nds08: posts the ante 175
flagao: posts the ante 175
JorgeCross5: posts the ante 175
LA_nds08: posts small blind 700
flagao: posts big blind 1400
*** HOLE CARDS ***
Dealt to flagao [7d 9d]
JorgeCross5: folds 
rafinha.nr: calls 1400
LGPRENDES: folds 
kinnho007: folds 
LA_nds08: folds 
flagao: checks 
*** FLOP *** [4d Jd 2c]
flagao: bets 2800
rafinha.nr: folds 
Uncalled bet (2800) returned to flagao
flagao collected 4550 from pot
flagao: doesn't show hand 
*** SUMMARY ***
Total pot 4550 | Rake 0 
Board [4d Jd 2c]
Seat 2: rafinha.nr folded on the Flop
Seat 3: LGPRENDES folded before Flop (didn't bet)
Seat 4: kinnho007 (button) folded before Flop (didn't bet)
Seat 5: LA_nds08 (small blind) folded before Flop
Seat 6: flagao (big blind) collected (4550)
Seat 8: JorgeCross5 folded before Flop (didn't bet)



PokerStars Home Game Hand #211092867900: {Club #3217684} Tournament #2845705715, 17000+3000 Hold'em No Limit - Level XIX (700/1400) - 2020/04/01 0:02:34 ET
Table '2845705715 2' 9-max Seat #5 is the button
Seat 2: rafinha.nr (49065 in chips) 
Seat 3: LGPRENDES (58857 in chips) 
Seat 4: kinnho007 (45240 in chips) 
Seat 5: LA_nds08 (25819 in chips) 
Seat 6: flagao (72134 in chips) 
Seat 8: JorgeCross5 (28885 in chips) 
rafinha.nr: posts the ante 175
LGPRENDES: posts the ante 175
kinnho007: posts the ante 175
LA_nds08: posts the ante 175
flagao: posts the ante 175
JorgeCross5: posts the ante 175
flagao: posts small blind 700
JorgeCross5: posts big blind 1400
*** HOLE CARDS ***
Dealt to flagao [Jd 7c]
rafinha.nr: folds 
LGPRENDES: raises 1400 to 2800
kinnho007: folds 
LA_nds08: folds 
flagao: folds 
JorgeCross5: calls 1400
*** FLOP *** [3c 5s 6s]
JorgeCross5: checks 
LGPRENDES: bets 3675
JorgeCross5: folds 
Uncalled bet (3675) returned to LGPRENDES
LGPRENDES collected 7350 from pot
LGPRENDES: doesn't show hand 
*** SUMMARY ***
Total pot 7350 | Rake 0 
Board [3c 5s 6s]
Seat 2: rafinha.nr folded before Flop (didn't bet)
Seat 3: LGPRENDES collected (7350)
Seat 4: kinnho007 folded before Flop (didn't bet)
Seat 5: LA_nds08 (button) folded before Flop (didn't bet)
Seat 6: flagao (small blind) folded before Flop
Seat 8: JorgeCross5 (big blind) folded on the Flop



PokerStars Home Game Hand #211092882219: {Club #3217684} Tournament #2845705715, 17000+3000 Hold'em No Limit - Level XIX (700/1400) - 2020/04/01 0:03:12 ET
Table '2845705715 2' 9-max Seat #6 is the button
Seat 2: rafinha.nr (48890 in chips) 
Seat 3: LGPRENDES (63232 in chips) 
Seat 4: kinnho007 (45065 in chips) 
Seat 5: LA_nds08 (25644 in chips) 
Seat 6: flagao (71259 in chips) 
Seat 8: JorgeCross5 (25910 in chips) 
rafinha.nr: posts the ante 175
LGPRENDES: posts the ante 175
kinnho007: posts the ante 175
LA_nds08: posts the ante 175
flagao: posts the ante 175
JorgeCross5: posts the ante 175
JorgeCross5: posts small blind 700
rafinha.nr: posts big blind 1400
*** HOLE CARDS ***
Dealt to flagao [5s 3h]
LGPRENDES: folds 
kinnho007: folds 
LA_nds08: folds 
flagao: folds 
JorgeCross5: calls 700
rafinha.nr: checks 
*** FLOP *** [9h 7h Td]
JorgeCross5: checks 
rafinha.nr: bets 1400
JorgeCross5: calls 1400
*** TURN *** [9h 7h Td] [2s]
JorgeCross5: checks 
rafinha.nr: bets 1400
JorgeCross5: raises 21535 to 22935 and is all-in
rafinha.nr: calls 21535
*** RIVER *** [9h 7h Td 2s] [Th]
*** SHOW DOWN ***
JorgeCross5: shows [2h 2d] (a full house, Deuces full of Tens)
rafinha.nr: shows [6d 8c] (a straight, Six to Ten)
JorgeCross5 collected 52520 from pot
rafinha.nr said, "pqp"
*** SUMMARY ***
Total pot 52520 | Rake 0 
Board [9h 7h Td 2s Th]
Seat 2: rafinha.nr (big blind) showed [6d 8c] and lost with a straight, Six to Ten
Seat 3: LGPRENDES folded before Flop (didn't bet)
Seat 4: kinnho007 folded before Flop (didn't bet)
Seat 5: LA_nds08 folded before Flop (didn't bet)
Seat 6: flagao (button) folded before Flop (didn't bet)
Seat 8: JorgeCross5 (small blind) showed [2h 2d] and won (52520) with a full house, Deuces full of Tens



PokerStars Home Game Hand #211092913410: {Club #3217684} Tournament #2845705715, 17000+3000 Hold'em No Limit - Level XIX (700/1400) - 2020/04/01 0:04:18 ET
Table '2845705715 2' 9-max Seat #8 is the button
Seat 2: rafinha.nr (22980 in chips) 
Seat 3: LGPRENDES (63057 in chips) 
Seat 4: kinnho007 (44890 in chips) 
Seat 5: LA_nds08 (25469 in chips) 
Seat 6: flagao (71084 in chips) 
Seat 8: JorgeCross5 (52520 in chips) 
rafinha.nr: posts the ante 175
LGPRENDES: posts the ante 175
kinnho007: posts the ante 175
LA_nds08: posts the ante 175
flagao: posts the ante 175
JorgeCross5: posts the ante 175
rafinha.nr: posts small blind 700
LGPRENDES: posts big blind 1400
*** HOLE CARDS ***
Dealt to flagao [Ts Qc]
rafinha.nr said, "kkk"
kinnho007: folds 
LA_nds08: raises 23894 to 25294 and is all-in
flagao: folds 
JorgeCross5: folds 
rafinha.nr: folds 
LGPRENDES: folds 
Uncalled bet (23894) returned to LA_nds08
LA_nds08 collected 4550 from pot
LA_nds08: doesn't show hand 
*** SUMMARY ***
Total pot 4550 | Rake 0 
Seat 2: rafinha.nr (small blind) folded before Flop
Seat 3: LGPRENDES (big blind) folded before Flop
Seat 4: kinnho007 folded before Flop (didn't bet)
Seat 5: LA_nds08 collected (4550)
Seat 6: flagao folded before Flop (didn't bet)
Seat 8: JorgeCross5 (button) folded before Flop (didn't bet)



PokerStars Home Game Hand #211092925196: {Club #3217684} Tournament #2845705715, 17000+3000 Hold'em No Limit - Level XIX (700/1400) - 2020/04/01 0:04:49 ET
Table '2845705715 2' 9-max Seat #2 is the button
Seat 2: rafinha.nr (22105 in chips) 
Seat 3: LGPRENDES (61482 in chips) 
Seat 4: kinnho007 (44715 in chips) 
Seat 5: LA_nds08 (28444 in chips) 
Seat 6: flagao (70909 in chips) 
Seat 8: JorgeCross5 (52345 in chips) 
rafinha.nr: posts the ante 175
LGPRENDES: posts the ante 175
kinnho007: posts the ante 175
LA_nds08: posts the ante 175
flagao: posts the ante 175
JorgeCross5: posts the ante 175
LGPRENDES: posts small blind 700
kinnho007: posts big blind 1400
*** HOLE CARDS ***
Dealt to flagao [Qc 4h]
LA_nds08: folds 
flagao: folds 
JorgeCross5: folds 
LA_nds08 said, "hahaha"
rafinha.nr: folds 
LGPRENDES: calls 700
kinnho007: raises 2800 to 4200
LGPRENDES: folds 
Uncalled bet (2800) returned to kinnho007
kinnho007 collected 3850 from pot
kinnho007: doesn't show hand 
*** SUMMARY ***
Total pot 3850 | Rake 0 
Seat 2: rafinha.nr (button) folded before Flop (didn't bet)
Seat 3: LGPRENDES (small blind) folded before Flop
Seat 4: kinnho007 (big blind) collected (3850)
Seat 5: LA_nds08 folded before Flop (didn't bet)
Seat 6: flagao folded before Flop (didn't bet)
Seat 8: JorgeCross5 folded before Flop (didn't bet)



PokerStars Home Game Hand #211092951409: {Club #3217684} Tournament #2845705715, 17000+3000 Hold'em No Limit - Level XIX (700/1400) - 2020/04/01 0:05:58 ET
Table '2845705715 2' 9-max Seat #3 is the button
Seat 2: rafinha.nr (21930 in chips) 
Seat 3: LGPRENDES (59907 in chips) 
Seat 4: kinnho007 (46990 in chips) 
Seat 5: LA_nds08 (28269 in chips) 
Seat 6: flagao (70734 in chips) 
Seat 8: JorgeCross5 (52170 in chips) 
rafinha.nr: posts the ante 175
LGPRENDES: posts the ante 175
kinnho007: posts the ante 175
LA_nds08: posts the ante 175
flagao: posts the ante 175
JorgeCross5: posts the ante 175
kinnho007: posts small blind 700
LA_nds08: posts big blind 1400
*** HOLE CARDS ***
Dealt to flagao [5d Tc]
flagao: folds 
JorgeCross5: folds 
rafinha.nr: raises 1400 to 2800
LGPRENDES: folds 
kinnho007: folds 
LA_nds08: folds 
Uncalled bet (1400) returned to rafinha.nr
rafinha.nr collected 4550 from pot
rafinha.nr: doesn't show hand 
*** SUMMARY ***
Total pot 4550 | Rake 0 
Seat 2: rafinha.nr collected (4550)
Seat 3: LGPRENDES (button) folded before Flop (didn't bet)
Seat 4: kinnho007 (small blind) folded before Flop
Seat 5: LA_nds08 (big blind) folded before Flop
Seat 6: flagao folded before Flop (didn't bet)
Seat 8: JorgeCross5 folded before Flop (didn't bet)



PokerStars Home Game Hand #211092961187: {Club #3217684} Tournament #2845705715, 17000+3000 Hold'em No Limit - Level XIX (700/1400) - 2020/04/01 0:06:24 ET
Table '2845705715 2' 9-max Seat #4 is the button
Seat 2: rafinha.nr (24905 in chips) 
Seat 3: LGPRENDES (59732 in chips) 
Seat 4: kinnho007 (46115 in chips) 
Seat 5: LA_nds08 (26694 in chips) 
Seat 6: flagao (70559 in chips) 
Seat 8: JorgeCross5 (51995 in chips) 
rafinha.nr: posts the ante 175
LGPRENDES: posts the ante 175
kinnho007: posts the ante 175
LA_nds08: posts the ante 175
flagao: posts the ante 175
JorgeCross5: posts the ante 175
LA_nds08: posts small blind 700
flagao: posts big blind 1400
*** HOLE CARDS ***
Dealt to flagao [2s Tc]
JorgeCross5: folds 
rafinha.nr: folds 
LGPRENDES: raises 1400 to 2800
kinnho007: folds 
LA_nds08: folds 
flagao: folds 
Uncalled bet (1400) returned to LGPRENDES
LGPRENDES collected 4550 from pot
LGPRENDES: doesn't show hand 
*** SUMMARY ***
Total pot 4550 | Rake 0 
Seat 2: rafinha.nr folded before Flop (didn't bet)
Seat 3: LGPRENDES collected (4550)
Seat 4: kinnho007 (button) folded before Flop (didn't bet)
Seat 5: LA_nds08 (small blind) folded before Flop
Seat 6: flagao (big blind) folded before Flop
Seat 8: JorgeCross5 folded before Flop (didn't bet)



PokerStars Home Game Hand #211092968538: {Club #3217684} Tournament #2845705715, 17000+3000 Hold'em No Limit - Level XIX (700/1400) - 2020/04/01 0:06:43 ET
Table '2845705715 2' 9-max Seat #5 is the button
Seat 2: rafinha.nr (24730 in chips) 
Seat 3: LGPRENDES (62707 in chips) 
Seat 4: kinnho007 (45940 in chips) 
Seat 5: LA_nds08 (25819 in chips) 
Seat 6: flagao (68984 in chips) 
Seat 8: JorgeCross5 (51820 in chips) 
rafinha.nr: posts the ante 175
LGPRENDES: posts the ante 175
kinnho007: posts the ante 175
LA_nds08: posts the ante 175
flagao: posts the ante 175
JorgeCross5: posts the ante 175
flagao: posts small blind 700
JorgeCross5: posts big blind 1400
*** HOLE CARDS ***
Dealt to flagao [Tc Th]
rafinha.nr: folds 
LGPRENDES: calls 1400
kinnho007: folds 
LA_nds08: folds 
flagao: raises 2800 to 4200
JorgeCross5: folds 
LGPRENDES: calls 2800
*** FLOP *** [Kh Ah Kd]
flagao: bets 4200
LGPRENDES: folds 
Uncalled bet (4200) returned to flagao
flagao collected 10850 from pot
flagao: doesn't show hand 
*** SUMMARY ***
Total pot 10850 | Rake 0 
Board [Kh Ah Kd]
Seat 2: rafinha.nr folded before Flop (didn't bet)
Seat 3: LGPRENDES folded on the Flop
Seat 4: kinnho007 folded before Flop (didn't bet)
Seat 5: LA_nds08 (button) folded before Flop (didn't bet)
Seat 6: flagao (small blind) collected (10850)
Seat 8: JorgeCross5 (big blind) folded before Flop



PokerStars Home Game Hand #211092982306: {Club #3217684} Tournament #2845705715, 17000+3000 Hold'em No Limit - Level XIX (700/1400) - 2020/04/01 0:07:19 ET
Table '2845705715 2' 9-max Seat #6 is the button
Seat 2: rafinha.nr (24555 in chips) 
Seat 3: LGPRENDES (58332 in chips) 
Seat 4: kinnho007 (45765 in chips) 
Seat 5: LA_nds08 (25644 in chips) 
Seat 6: flagao (75459 in chips) 
Seat 8: JorgeCross5 (50245 in chips) 
rafinha.nr: posts the ante 175
LGPRENDES: posts the ante 175
kinnho007: posts the ante 175
LA_nds08: posts the ante 175
flagao: posts the ante 175
JorgeCross5: posts the ante 175
JorgeCross5: posts small blind 700
rafinha.nr: posts big blind 1400
*** HOLE CARDS ***
Dealt to flagao [Ah As]
LGPRENDES: folds 
kinnho007: folds 
LA_nds08: folds 
flagao: raises 1400 to 2800
JorgeCross5: folds 
rafinha.nr: folds 
Uncalled bet (1400) returned to flagao
flagao collected 4550 from pot
flagao: doesn't show hand 
*** SUMMARY ***
Total pot 4550 | Rake 0 
Seat 2: rafinha.nr (big blind) folded before Flop
Seat 3: LGPRENDES folded before Flop (didn't bet)
Seat 4: kinnho007 folded before Flop (didn't bet)
Seat 5: LA_nds08 folded before Flop (didn't bet)
Seat 6: flagao (button) collected (4550)
Seat 8: JorgeCross5 (small blind) folded before Flop



PokerStars Home Game Hand #211092991595: {Club #3217684} Tournament #2845705715, 17000+3000 Hold'em No Limit - Level XIX (700/1400) - 2020/04/01 0:07:44 ET
Table '2845705715 2' 9-max Seat #8 is the button
Seat 2: rafinha.nr (22980 in chips) 
Seat 3: LGPRENDES (58157 in chips) 
Seat 4: kinnho007 (45590 in chips) 
Seat 5: LA_nds08 (25469 in chips) 
Seat 6: flagao (78434 in chips) 
Seat 8: JorgeCross5 (49370 in chips) 
rafinha.nr: posts the ante 175
LGPRENDES: posts the ante 175
kinnho007: posts the ante 175
LA_nds08: posts the ante 175
flagao: posts the ante 175
JorgeCross5: posts the ante 175
rafinha.nr: posts small blind 700
LGPRENDES: posts big blind 1400
*** HOLE CARDS ***
Dealt to flagao [Ts Jd]
kinnho007: folds 
LA_nds08: folds 
flagao: raises 1400 to 2800
JorgeCross5: folds 
rafinha.nr: raises 20005 to 22805 and is all-in
LGPRENDES: folds 
flagao: folds 
Uncalled bet (20005) returned to rafinha.nr
rafinha.nr collected 8050 from pot
rafinha.nr: doesn't show hand 
*** SUMMARY ***
Total pot 8050 | Rake 0 
Seat 2: rafinha.nr (small blind) collected (8050)
Seat 3: LGPRENDES (big blind) folded before Flop
Seat 4: kinnho007 folded before Flop (didn't bet)
Seat 5: LA_nds08 folded before Flop (didn't bet)
Seat 6: flagao folded before Flop
Seat 8: JorgeCross5 (button) folded before Flop (didn't bet)



PokerStars Home Game Hand #211093008179: {Club #3217684} Tournament #2845705715, 17000+3000 Hold'em No Limit - Level XIX (700/1400) - 2020/04/01 0:08:06 ET
Table '2845705715 2' 9-max Seat #2 is the button
Seat 2: rafinha.nr (28055 in chips) 
Seat 3: LGPRENDES (56582 in chips) 
Seat 4: kinnho007 (45415 in chips) 
Seat 5: LA_nds08 (25294 in chips) 
Seat 6: flagao (75459 in chips) 
Seat 8: JorgeCross5 (49195 in chips) 
rafinha.nr: posts the ante 175
LGPRENDES: posts the ante 175
kinnho007: posts the ante 175
LA_nds08: posts the ante 175
flagao: posts the ante 175
JorgeCross5: posts the ante 175
LGPRENDES: posts small blind 700
kinnho007: posts big blind 1400
*** HOLE CARDS ***
Dealt to flagao [9c 7d]
LA_nds08: folds 
flagao: folds 
JorgeCross5: folds 
rafinha.nr: raises 26480 to 27880 and is all-in
LGPRENDES: folds 
kinnho007: folds 
Uncalled bet (26480) returned to rafinha.nr
rafinha.nr collected 4550 from pot
rafinha.nr: doesn't show hand 
*** SUMMARY ***
Total pot 4550 | Rake 0 
Seat 2: rafinha.nr (button) collected (4550)
Seat 3: LGPRENDES (small blind) folded before Flop
Seat 4: kinnho007 (big blind) folded before Flop
Seat 5: LA_nds08 folded before Flop (didn't bet)
Seat 6: flagao folded before Flop (didn't bet)
Seat 8: JorgeCross5 folded before Flop (didn't bet)



PokerStars Home Game Hand #211093021556: {Club #3217684} Tournament #2845705715, 17000+3000 Hold'em No Limit - Level XIX (700/1400) - 2020/04/01 0:08:42 ET
Table '2845705715 2' 9-max Seat #3 is the button
Seat 2: rafinha.nr (31030 in chips) 
Seat 3: LGPRENDES (55707 in chips) 
Seat 4: kinnho007 (43840 in chips) 
Seat 5: LA_nds08 (25119 in chips) 
Seat 6: flagao (75284 in chips) 
Seat 8: JorgeCross5 (49020 in chips) 
rafinha.nr: posts the ante 175
LGPRENDES: posts the ante 175
kinnho007: posts the ante 175
LA_nds08: posts the ante 175
flagao: posts the ante 175
JorgeCross5: posts the ante 175
kinnho007: posts small blind 700
LA_nds08: posts big blind 1400
*** HOLE CARDS ***
Dealt to flagao [7s 9d]
flagao: folds 
JorgeCross5: folds 
rafinha.nr: calls 1400
LGPRENDES: folds 
kinnho007: calls 700
LA_nds08: checks 
*** FLOP *** [Jd 5c Qs]
kinnho007: checks 
LA_nds08: checks 
rafinha.nr: bets 2800
kinnho007: folds 
LA_nds08: folds 
Uncalled bet (2800) returned to rafinha.nr
rafinha.nr collected 5250 from pot
rafinha.nr: doesn't show hand 
*** SUMMARY ***
Total pot 5250 | Rake 0 
Board [Jd 5c Qs]
Seat 2: rafinha.nr collected (5250)
Seat 3: LGPRENDES (button) folded before Flop (didn't bet)
Seat 4: kinnho007 (small blind) folded on the Flop
Seat 5: LA_nds08 (big blind) folded on the Flop
Seat 6: flagao folded before Flop (didn't bet)
Seat 8: JorgeCross5 folded before Flop (didn't bet)



PokerStars Home Game Hand #211093037874: {Club #3217684} Tournament #2845705715, 17000+3000 Hold'em No Limit - Level XIX (700/1400) - 2020/04/01 0:09:26 ET
Table '2845705715 2' 9-max Seat #4 is the button
Seat 2: rafinha.nr (34705 in chips) 
Seat 3: LGPRENDES (55532 in chips) 
Seat 4: kinnho007 (42265 in chips) 
Seat 5: LA_nds08 (23544 in chips) 
Seat 6: flagao (75109 in chips) 
Seat 8: JorgeCross5 (48845 in chips) 
rafinha.nr: posts the ante 175
LGPRENDES: posts the ante 175
kinnho007: posts the ante 175
LA_nds08: posts the ante 175
flagao: posts the ante 175
JorgeCross5: posts the ante 175
LA_nds08: posts small blind 700
flagao: posts big blind 1400
*** HOLE CARDS ***
Dealt to flagao [Kc 3d]
JorgeCross5: folds 
rafinha.nr: raises 2800 to 4200
LGPRENDES: calls 4200
kinnho007: folds 
LA_nds08: raises 19169 to 23369 and is all-in
flagao: folds 
rafinha.nr: raises 11161 to 34530 and is all-in
LGPRENDES: folds 
Uncalled bet (11161) returned to rafinha.nr
*** FLOP *** [Qc 9h 6c]
*** TURN *** [Qc 9h 6c] [8c]
*** RIVER *** [Qc 9h 6c 8c] [5d]
*** SHOW DOWN ***
LA_nds08: shows [7d Ad] (a straight, Five to Nine)
rafinha.nr: shows [Kh Qh] (a pair of Queens)
LA_nds08 collected 53388 from pot
*** SUMMARY ***
Total pot 53388 | Rake 0 
Board [Qc 9h 6c 8c 5d]
Seat 2: rafinha.nr showed [Kh Qh] and lost with a pair of Queens
Seat 3: LGPRENDES folded before Flop
Seat 4: kinnho007 (button) folded before Flop (didn't bet)
Seat 5: LA_nds08 (small blind) showed [7d Ad] and won (53388) with a straight, Five to Nine
Seat 6: flagao (big blind) folded before Flop
Seat 8: JorgeCross5 folded before Flop (didn't bet)



PokerStars Home Game Hand #211093058504: {Club #3217684} Tournament #2845705715, 17000+3000 Hold'em No Limit - Level XX (800/1600) - 2020/04/01 0:10:21 ET
Table '2845705715 2' 9-max Seat #5 is the button
Seat 2: rafinha.nr (11161 in chips) 
Seat 3: LGPRENDES (51157 in chips) 
Seat 4: kinnho007 (42090 in chips) 
Seat 5: LA_nds08 (53388 in chips) 
Seat 6: flagao (73534 in chips) 
Seat 8: JorgeCross5 (48670 in chips) 
rafinha.nr: posts the ante 200
LGPRENDES: posts the ante 200
kinnho007: posts the ante 200
LA_nds08: posts the ante 200
flagao: posts the ante 200
JorgeCross5: posts the ante 200
flagao: posts small blind 800
JorgeCross5: posts big blind 1600
*** HOLE CARDS ***
Dealt to flagao [8h 2s]
rafinha.nr said, "porra cayami"
flagao said, "Seguiiiiiiu"
LA_nds08 said, "shame"
rafinha.nr: raises 9361 to 10961 and is all-in
LGPRENDES: folds 
kinnho007: folds 
LA_nds08: calls 10961
flagao: folds 
JorgeCross5: folds 
*** FLOP *** [Qd 5h 4s]
*** TURN *** [Qd 5h 4s] [8c]
*** RIVER *** [Qd 5h 4s 8c] [Kd]
*** SHOW DOWN ***
rafinha.nr: shows [4h 4d] (three of a kind, Fours)
LA_nds08: shows [Kh Kc] (three of a kind, Kings)
rafinha.nr said, "kkkkkkkkk"
LA_nds08 collected 25522 from pot
rafinha.nr finished the tournament in 6th place
rafinha.nr said, "vtc"
kinnho007 said, "kkkkkkkkkkkkkkkkkkkkkkkkkkkkkkkkk"
*** SUMMARY ***
Total pot 25522 | Rake 0 
Board [Qd 5h 4s 8c Kd]
Seat 2: rafinha.nr showed [4h 4d] and lost with three of a kind, Fours
Seat 3: LGPRENDES folded before Flop (didn't bet)
Seat 4: kinnho007 folded before Flop (didn't bet)
Seat 5: LA_nds08 (button) showed [Kh Kc] and won (25522) with three of a kind, Kings
Seat 6: flagao (small blind) folded before Flop
Seat 8: JorgeCross5 (big blind) folded before Flop



PokerStars Home Game Hand #211093072866: {Club #3217684} Tournament #2845705715, 17000+3000 Hold'em No Limit - Level XX (800/1600) - 2020/04/01 0:10:59 ET
Table '2845705715 2' 9-max Seat #6 is the button
Seat 3: LGPRENDES (50957 in chips) 
Seat 4: kinnho007 (41890 in chips) 
Seat 5: LA_nds08 (67749 in chips) 
Seat 6: flagao (72534 in chips) 
Seat 8: JorgeCross5 (46870 in chips) 
LGPRENDES: posts the ante 200
kinnho007: posts the ante 200
LA_nds08: posts the ante 200
flagao: posts the ante 200
JorgeCross5: posts the ante 200
JorgeCross5: posts small blind 800
LGPRENDES: posts big blind 1600
*** HOLE CARDS ***
Dealt to flagao [Qd Qs]
LA_nds08 said, "olha"
flagao said, "FEIUUUUUUUU"
kinnho007: folds 
LA_nds08 said, "parabens"
LA_nds08: folds 
flagao: raises 1600 to 3200
JorgeCross5: folds 
LGPRENDES: calls 1600
*** FLOP *** [3c Td Qh]
LGPRENDES: bets 1600
flagao: calls 1600
*** TURN *** [3c Td Qh] [Ad]
LGPRENDES: bets 4800
flagao: calls 4800
*** RIVER *** [3c Td Qh Ad] [Ah]
LGPRENDES: checks 
LA_nds08 said, "hahaha"
flagao: bets 9600
LGPRENDES: raises 31557 to 41157 and is all-in
flagao: calls 31557
*** SHOW DOWN ***
LGPRENDES: shows [As 3h] (a full house, Aces full of Threes)
flagao: shows [Qd Qs] (a full house, Queens full of Aces)
LGPRENDES collected 103314 from pot
*** SUMMARY ***
Total pot 103314 | Rake 0 
Board [3c Td Qh Ad Ah]
Seat 3: LGPRENDES (big blind) showed [As 3h] and won (103314) with a full house, Aces full of Threes
Seat 4: kinnho007 folded before Flop (didn't bet)
Seat 5: LA_nds08 folded before Flop (didn't bet)
Seat 6: flagao (button) showed [Qd Qs] and lost with a full house, Queens full of Aces
Seat 8: JorgeCross5 (small blind) folded before Flop



PokerStars Home Game Hand #211093098624: {Club #3217684} Tournament #2845705715, 17000+3000 Hold'em No Limit - Level XX (800/1600) - 2020/04/01 0:12:07 ET
Table '2845705715 2' 9-max Seat #8 is the button
Seat 3: LGPRENDES (103314 in chips) 
Seat 4: kinnho007 (41690 in chips) 
Seat 5: LA_nds08 (67549 in chips) 
Seat 6: flagao (21577 in chips) 
Seat 8: JorgeCross5 (45870 in chips) 
LGPRENDES: posts the ante 200
kinnho007: posts the ante 200
LA_nds08: posts the ante 200
flagao: posts the ante 200
JorgeCross5: posts the ante 200
LGPRENDES: posts small blind 800
kinnho007: posts big blind 1600
*** HOLE CARDS ***
Dealt to flagao [4h Ac]
LA_nds08: folds 
flagao: folds 
JorgeCross5: folds 
LGPRENDES: raises 1600 to 3200
kinnho007: calls 1600
*** FLOP *** [Js 5s Ks]
LGPRENDES: bets 1600
kinnho007: folds 
Uncalled bet (1600) returned to LGPRENDES
LA_nds08 said, "caraio"
LGPRENDES collected 7400 from pot
LGPRENDES: doesn't show hand 
*** SUMMARY ***
Total pot 7400 | Rake 0 
Board [Js 5s Ks]
Seat 3: LGPRENDES (small blind) collected (7400)
Seat 4: kinnho007 (big blind) folded on the Flop
Seat 5: LA_nds08 folded before Flop (didn't bet)
Seat 6: flagao folded before Flop (didn't bet)
Seat 8: JorgeCross5 (button) folded before Flop (didn't bet)



PokerStars Home Game Hand #211093116385: {Club #3217684} Tournament #2845705715, 17000+3000 Hold'em No Limit - Level XX (800/1600) - 2020/04/01 0:12:47 ET
Table '2845705715 2' 9-max Seat #3 is the button
Seat 3: LGPRENDES (107314 in chips) 
Seat 4: kinnho007 (38290 in chips) 
Seat 5: LA_nds08 (67349 in chips) 
Seat 6: flagao (21377 in chips) 
Seat 8: JorgeCross5 (45670 in chips) 
LGPRENDES: posts the ante 200
kinnho007: posts the ante 200
LA_nds08: posts the ante 200
flagao: posts the ante 200
JorgeCross5: posts the ante 200
kinnho007: posts small blind 800
LA_nds08: posts big blind 1600
*** HOLE CARDS ***
Dealt to flagao [Td Kd]
flagao: raises 1600 to 3200
JorgeCross5: folds 
LGPRENDES: calls 3200
kinnho007: folds 
LA_nds08: calls 1600
*** FLOP *** [Qh Kc 7s]
LA_nds08: checks 
flagao: bets 3200
LGPRENDES: folds 
LA_nds08: folds 
Uncalled bet (3200) returned to flagao
flagao collected 11400 from pot
flagao: doesn't show hand 
*** SUMMARY ***
Total pot 11400 | Rake 0 
Board [Qh Kc 7s]
Seat 3: LGPRENDES (button) folded on the Flop
Seat 4: kinnho007 (small blind) folded before Flop
Seat 5: LA_nds08 (big blind) folded on the Flop
Seat 6: flagao collected (11400)
Seat 8: JorgeCross5 folded before Flop (didn't bet)



PokerStars Home Game Hand #211093137120: {Club #3217684} Tournament #2845705715, 17000+3000 Hold'em No Limit - Level XX (800/1600) - 2020/04/01 0:13:42 ET
Table '2845705715 2' 9-max Seat #4 is the button
Seat 3: LGPRENDES (103914 in chips) 
Seat 4: kinnho007 (37290 in chips) 
Seat 5: LA_nds08 (63949 in chips) 
Seat 6: flagao (29377 in chips) 
Seat 8: JorgeCross5 (45470 in chips) 
LGPRENDES: posts the ante 200
kinnho007: posts the ante 200
LA_nds08: posts the ante 200
flagao: posts the ante 200
JorgeCross5: posts the ante 200
LA_nds08: posts small blind 800
flagao: posts big blind 1600
*** HOLE CARDS ***
Dealt to flagao [2h 5h]
JorgeCross5: calls 1600
LGPRENDES: folds 
kinnho007: raises 3200 to 4800
LA_nds08: folds 
flagao: folds 
JorgeCross5: calls 3200
*** FLOP *** [4h 9s Td]
JorgeCross5: bets 40470 and is all-in
kinnho007: folds 
Uncalled bet (40470) returned to JorgeCross5
JorgeCross5 collected 13000 from pot
JorgeCross5: doesn't show hand 
*** SUMMARY ***
Total pot 13000 | Rake 0 
Board [4h 9s Td]
Seat 3: LGPRENDES folded before Flop (didn't bet)
Seat 4: kinnho007 (button) folded on the Flop
Seat 5: LA_nds08 (small blind) folded before Flop
Seat 6: flagao (big blind) folded before Flop
Seat 8: JorgeCross5 collected (13000)



PokerStars Home Game Hand #211093165334: {Club #3217684} Tournament #2845705715, 17000+3000 Hold'em No Limit - Level XX (800/1600) - 2020/04/01 0:14:58 ET
Table '2845705715 2' 9-max Seat #5 is the button
Seat 3: LGPRENDES (103714 in chips) 
Seat 4: kinnho007 (32290 in chips) 
Seat 5: LA_nds08 (62949 in chips) 
Seat 6: flagao (27577 in chips) 
Seat 8: JorgeCross5 (53470 in chips) 
LGPRENDES: posts the ante 200
kinnho007: posts the ante 200
LA_nds08: posts the ante 200
flagao: posts the ante 200
JorgeCross5: posts the ante 200
flagao: posts small blind 800
JorgeCross5: posts big blind 1600
*** HOLE CARDS ***
Dealt to flagao [3c Kc]
kinnho007 said, "porr cross"
flagao said, "Gabriel... nunca mais acerta... AA runner runner"
LGPRENDES: folds 
kinnho007 said, "kkkkkk"
kinnho007: folds 
LA_nds08: folds 
flagao: raises 1600 to 3200
LA_nds08 said, "mas foi o 2 par no turn vc foi dando call bateu"
JorgeCross5: raises 24000 to 27200
flagao: folds 
Uncalled bet (24000) returned to JorgeCross5
JorgeCross5 collected 7400 from pot
JorgeCross5: doesn't show hand 
*** SUMMARY ***
Total pot 7400 | Rake 0 
Seat 3: LGPRENDES folded before Flop (didn't bet)
Seat 4: kinnho007 folded before Flop (didn't bet)
Seat 5: LA_nds08 (button) folded before Flop (didn't bet)
Seat 6: flagao (small blind) folded before Flop
Seat 8: JorgeCross5 (big blind) collected (7400)



PokerStars Home Game Hand #211093183991: {Club #3217684} Tournament #2845705715, 17000+3000 Hold'em No Limit - Level XX (800/1600) - 2020/04/01 0:15:49 ET
Table '2845705715 2' 9-max Seat #6 is the button
Seat 3: LGPRENDES (103514 in chips) 
Seat 4: kinnho007 (32090 in chips) 
Seat 5: LA_nds08 (62749 in chips) 
Seat 6: flagao (24177 in chips) 
Seat 8: JorgeCross5 (57470 in chips) 
LGPRENDES: posts the ante 200
kinnho007: posts the ante 200
LA_nds08: posts the ante 200
flagao: posts the ante 200
JorgeCross5: posts the ante 200
JorgeCross5: posts small blind 800
LGPRENDES: posts big blind 1600
*** HOLE CARDS ***
Dealt to flagao [9c Jd]
kinnho007: calls 1600
LA_nds08: raises 3400 to 5000
flagao: folds 
JorgeCross5: folds 
LGPRENDES: folds 
kinnho007: calls 3400
*** FLOP *** [7h 8s 4s]
flagao said, "QQ eu trinco vou apostar? tÃ¡ louco"
kinnho007: checks 
LA_nds08: bets 6700
kinnho007: folds 
Uncalled bet (6700) returned to LA_nds08
LA_nds08 collected 13400 from pot
*** SUMMARY ***
Total pot 13400 | Rake 0 
Board [7h 8s 4s]
Seat 3: LGPRENDES (big blind) folded before Flop
Seat 4: kinnho007 folded on the Flop
Seat 5: LA_nds08 collected (13400)
Seat 6: flagao (button) folded before Flop (didn't bet)
Seat 8: JorgeCross5 (small blind) folded before Flop



PokerStars Home Game Hand #211093201571: {Club #3217684} Tournament #2845705715, 17000+3000 Hold'em No Limit - Level XX (800/1600) - 2020/04/01 0:16:37 ET
Table '2845705715 2' 9-max Seat #8 is the button
Seat 3: LGPRENDES (101714 in chips) 
Seat 4: kinnho007 (26890 in chips) 
Seat 5: LA_nds08 (70949 in chips) 
Seat 6: flagao (23977 in chips) 
Seat 8: JorgeCross5 (56470 in chips) 
LGPRENDES: posts the ante 200
kinnho007: posts the ante 200
LA_nds08: posts the ante 200
flagao: posts the ante 200
JorgeCross5: posts the ante 200
LGPRENDES: posts small blind 800
kinnho007: posts big blind 1600
*** HOLE CARDS ***
Dealt to flagao [Js 4s]
LA_nds08: folds 
flagao: folds 
JorgeCross5: folds 
LA_nds08 said, "Eu sei"
LGPRENDES: calls 800
kinnho007: raises 25090 to 26690 and is all-in
LGPRENDES: folds 
Uncalled bet (25090) returned to kinnho007
kinnho007 collected 4200 from pot
kinnho007: doesn't show hand 
*** SUMMARY ***
Total pot 4200 | Rake 0 
Seat 3: LGPRENDES (small blind) folded before Flop
Seat 4: kinnho007 (big blind) collected (4200)
Seat 5: LA_nds08 folded before Flop (didn't bet)
Seat 6: flagao folded before Flop (didn't bet)
Seat 8: JorgeCross5 (button) folded before Flop (didn't bet)



PokerStars Home Game Hand #211093217839: {Club #3217684} Tournament #2845705715, 17000+3000 Hold'em No Limit - Level XX (800/1600) - 2020/04/01 0:17:21 ET
Table '2845705715 2' 9-max Seat #3 is the button
Seat 3: LGPRENDES (99914 in chips) 
Seat 4: kinnho007 (29290 in chips) 
Seat 5: LA_nds08 (70749 in chips) 
Seat 6: flagao (23777 in chips) 
Seat 8: JorgeCross5 (56270 in chips) 
LGPRENDES: posts the ante 200
kinnho007: posts the ante 200
LA_nds08: posts the ante 200
flagao: posts the ante 200
JorgeCross5: posts the ante 200
kinnho007: posts small blind 800
LA_nds08: posts big blind 1600
*** HOLE CARDS ***
Dealt to flagao [9s 5h]
flagao: folds 
JorgeCross5: folds 
LGPRENDES is disconnected 
LA_nds08 is disconnected 
LGPRENDES has timed out while disconnected
LGPRENDES: folds 
kinnho007: calls 800
LA_nds08 is connected 
LA_nds08: checks 
*** FLOP *** [7h 5c 4d]
kinnho007: bets 1600
LA_nds08: calls 1600
*** TURN *** [7h 5c 4d] [Kd]
kinnho007: bets 1600
LA_nds08: calls 1600
*** RIVER *** [7h 5c 4d Kd] [2c]
kinnho007: bets 1600
LA_nds08: calls 1600
*** SHOW DOWN ***
kinnho007: shows [6s 4c] (a pair of Fours)
LA_nds08: shows [6h 6d] (a pair of Sixes)
LA_nds08 collected 13800 from pot
*** SUMMARY ***
Total pot 13800 | Rake 0 
Board [7h 5c 4d Kd 2c]
Seat 3: LGPRENDES (button) folded before Flop (didn't bet)
Seat 4: kinnho007 (small blind) showed [6s 4c] and lost with a pair of Fours
Seat 5: LA_nds08 (big blind) showed [6h 6d] and won (13800) with a pair of Sixes
Seat 6: flagao folded before Flop (didn't bet)
Seat 8: JorgeCross5 folded before Flop (didn't bet)



PokerStars Home Game Hand #211093267676: {Club #3217684} Tournament #2845705715, 17000+3000 Hold'em No Limit - Level XX (800/1600) - 2020/04/01 0:19:11 ET
Table '2845705715 2' 9-max Seat #4 is the button
Seat 3: LGPRENDES (99714 in chips) 
Seat 4: kinnho007 (22690 in chips) 
Seat 5: LA_nds08 (77949 in chips) 
Seat 6: flagao (23577 in chips) 
Seat 8: JorgeCross5 (56070 in chips) 
LGPRENDES: posts the ante 200
kinnho007: posts the ante 200
LA_nds08: posts the ante 200
flagao: posts the ante 200
JorgeCross5: posts the ante 200
LA_nds08: posts small blind 800
flagao: posts big blind 1600
*** HOLE CARDS ***
Dealt to flagao [Ah 3s]
JorgeCross5: folds 
LGPRENDES: folds 
kinnho007: folds 
LA_nds08: raises 3200 to 4800
flagao: folds 
Uncalled bet (3200) returned to LA_nds08
LA_nds08 collected 4200 from pot
LA_nds08: doesn't show hand 
*** SUMMARY ***
Total pot 4200 | Rake 0 
Seat 3: LGPRENDES folded before Flop (didn't bet)
Seat 4: kinnho007 (button) folded before Flop (didn't bet)
Seat 5: LA_nds08 (small blind) collected (4200)
Seat 6: flagao (big blind) folded before Flop
Seat 8: JorgeCross5 folded before Flop (didn't bet)



PokerStars Home Game Hand #211093277100: {Club #3217684} Tournament #2845705715, 17000+3000 Hold'em No Limit - Level XX (800/1600) - 2020/04/01 0:19:37 ET
Table '2845705715 2' 9-max Seat #5 is the button
Seat 3: LGPRENDES (99514 in chips) 
Seat 4: kinnho007 (22490 in chips) 
Seat 5: LA_nds08 (80349 in chips) 
Seat 6: flagao (21777 in chips) 
Seat 8: JorgeCross5 (55870 in chips) 
LGPRENDES: posts the ante 200
kinnho007: posts the ante 200
LA_nds08: posts the ante 200
flagao: posts the ante 200
JorgeCross5: posts the ante 200
flagao: posts small blind 800
JorgeCross5: posts big blind 1600
*** HOLE CARDS ***
Dealt to flagao [Kd 9s]
LGPRENDES: raises 1600 to 3200
kinnho007: folds 
LA_nds08: folds 
flagao: folds 
JorgeCross5: folds 
Uncalled bet (1600) returned to LGPRENDES
LGPRENDES collected 5000 from pot
LGPRENDES: doesn't show hand 
*** SUMMARY ***
Total pot 5000 | Rake 0 
Seat 3: LGPRENDES collected (5000)
Seat 4: kinnho007 folded before Flop (didn't bet)
Seat 5: LA_nds08 (button) folded before Flop (didn't bet)
Seat 6: flagao (small blind) folded before Flop
Seat 8: JorgeCross5 (big blind) folded before Flop



PokerStars Home Game Hand #211093285674: {Club #3217684} Tournament #2845705715, 17000+3000 Hold'em No Limit - Level XX (800/1600) - 2020/04/01 0:20:01 ET
Table '2845705715 2' 9-max Seat #6 is the button
Seat 3: LGPRENDES (102714 in chips) 
Seat 4: kinnho007 (22290 in chips) 
Seat 5: LA_nds08 (80149 in chips) 
Seat 6: flagao (20777 in chips) 
Seat 8: JorgeCross5 (54070 in chips) 
LGPRENDES: posts the ante 200
kinnho007: posts the ante 200
LA_nds08: posts the ante 200
flagao: posts the ante 200
JorgeCross5: posts the ante 200
JorgeCross5: posts small blind 800
LGPRENDES: posts big blind 1600
*** HOLE CARDS ***
Dealt to flagao [5c Kd]
kinnho007: folds 
LA_nds08: folds 
flagao: raises 1600 to 3200
JorgeCross5: calls 2400
LGPRENDES: calls 1600
*** FLOP *** [4d 2d 6s]
JorgeCross5: bets 50670 and is all-in
LGPRENDES: folds 
flagao: folds 
Uncalled bet (50670) returned to JorgeCross5
JorgeCross5 collected 10600 from pot
JorgeCross5: doesn't show hand 
*** SUMMARY ***
Total pot 10600 | Rake 0 
Board [4d 2d 6s]
Seat 3: LGPRENDES (big blind) folded on the Flop
Seat 4: kinnho007 folded before Flop (didn't bet)
Seat 5: LA_nds08 folded before Flop (didn't bet)
Seat 6: flagao (button) folded on the Flop
Seat 8: JorgeCross5 (small blind) collected (10600)



PokerStars Home Game Hand #211093307644: {Club #3217684} Tournament #2845705715, 17000+3000 Hold'em No Limit - Level XXI (900/1800) - 2020/04/01 0:21:01 ET
Table '2845705715 2' 9-max Seat #8 is the button
Seat 3: LGPRENDES (99314 in chips) 
Seat 4: kinnho007 (22090 in chips) 
Seat 5: LA_nds08 (79949 in chips) 
Seat 6: flagao (17377 in chips) 
Seat 8: JorgeCross5 (61270 in chips) 
LGPRENDES: posts the ante 225
kinnho007: posts the ante 225
LA_nds08: posts the ante 225
flagao: posts the ante 225
JorgeCross5: posts the ante 225
LGPRENDES: posts small blind 900
kinnho007: posts big blind 1800
*** HOLE CARDS ***
Dealt to flagao [6c 8s]
LA_nds08: raises 1800 to 3600
flagao: folds 
JorgeCross5: folds 
LGPRENDES: calls 2700
kinnho007: calls 1800
*** FLOP *** [Kc 5s 7c]
LGPRENDES: checks 
kinnho007: checks 
LA_nds08: bets 5963
LGPRENDES: folds 
kinnho007: folds 
Uncalled bet (5963) returned to LA_nds08
LA_nds08 collected 11925 from pot
LA_nds08: doesn't show hand 
*** SUMMARY ***
Total pot 11925 | Rake 0 
Board [Kc 5s 7c]
Seat 3: LGPRENDES (small blind) folded on the Flop
Seat 4: kinnho007 (big blind) folded on the Flop
Seat 5: LA_nds08 collected (11925)
Seat 6: flagao folded before Flop (didn't bet)
Seat 8: JorgeCross5 (button) folded before Flop (didn't bet)



PokerStars Home Game Hand #211093322367: {Club #3217684} Tournament #2845705715, 17000+3000 Hold'em No Limit - Level XXI (900/1800) - 2020/04/01 0:21:41 ET
Table '2845705715 2' 9-max Seat #3 is the button
Seat 3: LGPRENDES (95489 in chips) 
Seat 4: kinnho007 (18265 in chips) 
Seat 5: LA_nds08 (88049 in chips) 
Seat 6: flagao (17152 in chips) 
Seat 8: JorgeCross5 (61045 in chips) 
LGPRENDES: posts the ante 225
kinnho007: posts the ante 225
LA_nds08: posts the ante 225
flagao: posts the ante 225
JorgeCross5: posts the ante 225
kinnho007: posts small blind 900
LA_nds08: posts big blind 1800
*** HOLE CARDS ***
Dealt to flagao [7c 6d]
flagao: folds 
JorgeCross5: calls 1800
LGPRENDES: raises 1800 to 3600
kinnho007: folds 
LA_nds08: calls 1800
JorgeCross5: calls 1800
*** FLOP *** [3c Ac 4c]
LA_nds08: checks 
JorgeCross5: bets 5400
LGPRENDES: folds 
LA_nds08: calls 5400
*** TURN *** [3c Ac 4c] [Tc]
LA_nds08: checks 
JorgeCross5: checks 
*** RIVER *** [3c Ac 4c Tc] [Qh]
LA_nds08: checks 
JorgeCross5: checks 
*** SHOW DOWN ***
LA_nds08: shows [4s 4d] (three of a kind, Fours)
JorgeCross5: mucks hand 
LA_nds08 collected 23625 from pot
*** SUMMARY ***
Total pot 23625 | Rake 0 
Board [3c Ac 4c Tc Qh]
Seat 3: LGPRENDES (button) folded on the Flop
Seat 4: kinnho007 (small blind) folded before Flop
Seat 5: LA_nds08 (big blind) showed [4s 4d] and won (23625) with three of a kind, Fours
Seat 6: flagao folded before Flop (didn't bet)
Seat 8: JorgeCross5 mucked [9s Ad]



PokerStars Home Game Hand #211093347440: {Club #3217684} Tournament #2845705715, 17000+3000 Hold'em No Limit - Level XXI (900/1800) - 2020/04/01 0:22:50 ET
Table '2845705715 2' 9-max Seat #4 is the button
Seat 3: LGPRENDES (91664 in chips) 
Seat 4: kinnho007 (17140 in chips) 
Seat 5: LA_nds08 (102449 in chips) 
Seat 6: flagao (16927 in chips) 
Seat 8: JorgeCross5 (51820 in chips) 
LGPRENDES: posts the ante 225
kinnho007: posts the ante 225
LA_nds08: posts the ante 225
flagao: posts the ante 225
JorgeCross5: posts the ante 225
LA_nds08: posts small blind 900
flagao: posts big blind 1800
*** HOLE CARDS ***
Dealt to flagao [2c Ts]
JorgeCross5: calls 1800
LGPRENDES: folds 
kinnho007: folds 
LA_nds08: folds 
flagao: checks 
*** FLOP *** [Ad Qh Ac]
flagao: checks 
JorgeCross5: checks 
*** TURN *** [Ad Qh Ac] [4h]
flagao: checks 
JorgeCross5: checks 
*** RIVER *** [Ad Qh Ac 4h] [9d]
flagao: checks 
JorgeCross5: bets 1800
flagao: folds 
Uncalled bet (1800) returned to JorgeCross5
JorgeCross5 collected 5625 from pot
JorgeCross5: doesn't show hand 
*** SUMMARY ***
Total pot 5625 | Rake 0 
Board [Ad Qh Ac 4h 9d]
Seat 3: LGPRENDES folded before Flop (didn't bet)
Seat 4: kinnho007 (button) folded before Flop (didn't bet)
Seat 5: LA_nds08 (small blind) folded before Flop
Seat 6: flagao (big blind) folded on the River
Seat 8: JorgeCross5 collected (5625)



PokerStars Home Game Hand #211093363683: {Club #3217684} Tournament #2845705715, 17000+3000 Hold'em No Limit - Level XXI (900/1800) - 2020/04/01 0:23:35 ET
Table '2845705715 2' 9-max Seat #5 is the button
Seat 3: LGPRENDES (91439 in chips) 
Seat 4: kinnho007 (16915 in chips) 
Seat 5: LA_nds08 (101324 in chips) 
Seat 6: flagao (14902 in chips) 
Seat 8: JorgeCross5 (55420 in chips) 
LGPRENDES: posts the ante 225
kinnho007: posts the ante 225
LA_nds08: posts the ante 225
flagao: posts the ante 225
JorgeCross5: posts the ante 225
flagao: posts small blind 900
JorgeCross5: posts big blind 1800
*** HOLE CARDS ***
Dealt to flagao [Tc Js]
LGPRENDES: calls 1800
kinnho007: folds 
LA_nds08: raises 3052 to 4852
flagao: folds 
JorgeCross5: folds 
LGPRENDES: calls 3052
*** FLOP *** [Jh 5c Qh]
LGPRENDES: checks 
LA_nds08: bets 3950
LGPRENDES: folds 
Uncalled bet (3950) returned to LA_nds08
LA_nds08 collected 13529 from pot
LA_nds08: doesn't show hand 
*** SUMMARY ***
Total pot 13529 | Rake 0 
Board [Jh 5c Qh]
Seat 3: LGPRENDES folded on the Flop
Seat 4: kinnho007 folded before Flop (didn't bet)
Seat 5: LA_nds08 (button) collected (13529)
Seat 6: flagao (small blind) folded before Flop
Seat 8: JorgeCross5 (big blind) folded before Flop



PokerStars Home Game Hand #211093390652: {Club #3217684} Tournament #2845705715, 17000+3000 Hold'em No Limit - Level XXI (900/1800) - 2020/04/01 0:24:50 ET
Table '2845705715 2' 9-max Seat #6 is the button
Seat 3: LGPRENDES (86362 in chips) 
Seat 4: kinnho007 (16690 in chips) 
Seat 5: LA_nds08 (109776 in chips) 
Seat 6: flagao (13777 in chips) 
Seat 8: JorgeCross5 (53395 in chips) 
LGPRENDES: posts the ante 225
kinnho007: posts the ante 225
LA_nds08: posts the ante 225
flagao: posts the ante 225
JorgeCross5: posts the ante 225
JorgeCross5: posts small blind 900
LGPRENDES: posts big blind 1800
*** HOLE CARDS ***
Dealt to flagao [5d 8d]
kinnho007: folds 
LA_nds08: folds 
flagao: folds 
JorgeCross5: calls 900
LGPRENDES: raises 1800 to 3600
JorgeCross5: calls 1800
*** FLOP *** [8h 2h 3c]
JorgeCross5: checks 
LGPRENDES: bets 4163
JorgeCross5: calls 4163
*** TURN *** [8h 2h 3c] [As]
JorgeCross5: checks 
LGPRENDES: bets 8326
JorgeCross5: calls 8326
*** RIVER *** [8h 2h 3c As] [8s]
JorgeCross5: checks 
LGPRENDES: bets 10800
JorgeCross5: folds 
Uncalled bet (10800) returned to LGPRENDES
LGPRENDES collected 33303 from pot
LGPRENDES: doesn't show hand 
*** SUMMARY ***
Total pot 33303 | Rake 0 
Board [8h 2h 3c As 8s]
Seat 3: LGPRENDES (big blind) collected (33303)
Seat 4: kinnho007 folded before Flop (didn't bet)
Seat 5: LA_nds08 folded before Flop (didn't bet)
Seat 6: flagao (button) folded before Flop (didn't bet)
Seat 8: JorgeCross5 (small blind) folded on the River



PokerStars Home Game Hand #211093426322: {Club #3217684} Tournament #2845705715, 17000+3000 Hold'em No Limit - Level XXI (900/1800) - 2020/04/01 0:26:28 ET
Table '2845705715 2' 9-max Seat #8 is the button
Seat 3: LGPRENDES (103351 in chips) 
Seat 4: kinnho007 (16465 in chips) 
Seat 5: LA_nds08 (109551 in chips) 
Seat 6: flagao (13552 in chips) 
Seat 8: JorgeCross5 (37081 in chips) 
LGPRENDES: posts the ante 225
kinnho007: posts the ante 225
LA_nds08: posts the ante 225
flagao: posts the ante 225
JorgeCross5: posts the ante 225
LGPRENDES: posts small blind 900
kinnho007: posts big blind 1800
*** HOLE CARDS ***
Dealt to flagao [Ts Js]
LA_nds08: folds 
flagao: raises 11527 to 13327 and is all-in
JorgeCross5: folds 
LGPRENDES: folds 
kinnho007: folds 
Uncalled bet (11527) returned to flagao
flagao collected 5625 from pot
flagao: doesn't show hand 
*** SUMMARY ***
Total pot 5625 | Rake 0 
Seat 3: LGPRENDES (small blind) folded before Flop
Seat 4: kinnho007 (big blind) folded before Flop
Seat 5: LA_nds08 folded before Flop (didn't bet)
Seat 6: flagao collected (5625)
Seat 8: JorgeCross5 (button) folded before Flop (didn't bet)



PokerStars Home Game Hand #211093434293: {Club #3217684} Tournament #2845705715, 17000+3000 Hold'em No Limit - Level XXI (900/1800) - 2020/04/01 0:26:50 ET
Table '2845705715 2' 9-max Seat #3 is the button
Seat 3: LGPRENDES (102226 in chips) 
Seat 4: kinnho007 (14440 in chips) 
Seat 5: LA_nds08 (109326 in chips) 
Seat 6: flagao (17152 in chips) 
Seat 8: JorgeCross5 (36856 in chips) 
LGPRENDES: posts the ante 225
kinnho007: posts the ante 225
LA_nds08: posts the ante 225
flagao: posts the ante 225
JorgeCross5: posts the ante 225
kinnho007: posts small blind 900
LA_nds08: posts big blind 1800
*** HOLE CARDS ***
Dealt to flagao [8s 2d]
flagao: folds 
JorgeCross5: raises 18000 to 19800
LGPRENDES: folds 
kinnho007: folds 
LA_nds08: raises 89301 to 109101 and is all-in
JorgeCross5: calls 16831 and is all-in
Uncalled bet (72470) returned to LA_nds08
*** FLOP *** [Ah Jh 8d]
*** TURN *** [Ah Jh 8d] [Jc]
*** RIVER *** [Ah Jh 8d Jc] [Kd]
*** SHOW DOWN ***
LA_nds08: shows [Td Th] (two pair, Jacks and Tens)
JorgeCross5: shows [Jd Tc] (three of a kind, Jacks)
JorgeCross5 collected 75287 from pot
*** SUMMARY ***
Total pot 75287 | Rake 0 
Board [Ah Jh 8d Jc Kd]
Seat 3: LGPRENDES (button) folded before Flop (didn't bet)
Seat 4: kinnho007 (small blind) folded before Flop
Seat 5: LA_nds08 (big blind) showed [Td Th] and lost with two pair, Jacks and Tens
Seat 6: flagao folded before Flop (didn't bet)
Seat 8: JorgeCross5 showed [Jd Tc] and won (75287) with three of a kind, Jacks



PokerStars Home Game Hand #211093480430: {Club #3217684} Tournament #2845705715, 17000+3000 Hold'em No Limit - Level XXI (900/1800) - 2020/04/01 0:28:58 ET
Table '2845705715 2' 9-max Seat #4 is the button
Seat 3: LGPRENDES (102001 in chips) 
Seat 4: kinnho007 (13315 in chips) 
Seat 5: LA_nds08 (72470 in chips) 
Seat 6: flagao (16927 in chips) 
Seat 8: JorgeCross5 (75287 in chips) 
LGPRENDES: posts the ante 225
kinnho007: posts the ante 225
LA_nds08: posts the ante 225
flagao: posts the ante 225
JorgeCross5: posts the ante 225
LA_nds08: posts small blind 900
flagao: posts big blind 1800
*** HOLE CARDS ***
Dealt to flagao [9s Ad]
JorgeCross5: calls 1800
LGPRENDES: folds 
kinnho007: folds 
LA_nds08: folds 
flagao: raises 14902 to 16702 and is all-in
JorgeCross5: calls 14902
*** FLOP *** [6h Qd 7c]
*** TURN *** [6h Qd 7c] [5s]
*** RIVER *** [6h Qd 7c 5s] [7s]
*** SHOW DOWN ***
flagao: shows [9s Ad] (a pair of Sevens)
JorgeCross5: shows [Jd Qc] (two pair, Queens and Sevens)
JorgeCross5 collected 35429 from pot
flagao finished the tournament in 5th place
*** SUMMARY ***
Total pot 35429 | Rake 0 
Board [6h Qd 7c 5s 7s]
Seat 3: LGPRENDES folded before Flop (didn't bet)
Seat 4: kinnho007 (button) folded before Flop (didn't bet)
Seat 5: LA_nds08 (small blind) folded before Flop
Seat 6: flagao (big blind) showed [9s Ad] and lost with a pair of Sevens
Seat 8: JorgeCross5 showed [Jd Qc] and won (35429) with two pair, Queens and Sevens


